Rank,Release Group,Worldwide,Domestic,Foreign,Filename,Year,Domestic %,Foreign %
1,Avengers: Endgame,2797501328,858373000,1939128328,2019.csv,2019,0.30683560054417247,0.6931643994558275
2,Star Wars: Episode VII - The Force Awakens,2068223624,936662225,1131561399,2015.csv,2015,0.4528824707980417,0.5471175292019583
3,Avengers: Infinity War,2048359754,678815482,1369544272,2018.csv,2018,0.3313946589091205,0.6686053410908794
4,Jurassic World,1670400637,652270625,1018130012,2015.csv,2015,0.39048753368022093,0.6095124663197791
5,The Lion King,1656943394,543638043,1113305351,2019.csv,2019,0.32809693135479556,0.6719030686452044
6,Furious 7,1515047671,353007020,1162040651,2015.csv,2015,0.23300060239490641,0.7669993976050936
7,Frozen II,1450026933,477373578,972653355,2019.csv,2019,0.329217042205105,0.6707829577948949
8,Avengers: Age of Ultron,1402805868,459005868,943800000,2015.csv,2015,0.3272055517235689,0.6727944482764311
9,Black Panther,1346913161,700059566,646853595,2018.csv,2018,0.5197510769589992,0.4802489230410007
10,Star Wars: Episode VIII - The Last Jedi,1332539889,620181382,712358507,2017.csv,2017,0.465412995978239,0.5345870040217611
11,Jurassic World: Fallen Kingdom,1308467944,417719760,890748184,2018.csv,2018,0.3192434036427567,0.6807565963572433
12,Beauty and the Beast,1263521126,504014165,759506961,2017.csv,2017,0.3988965080430321,0.6011034919569679
13,Incredibles 2,1242805359,608581744,634223615,2018.csv,2018,0.48968387494698595,0.510316125053014
14,The Fate of the Furious,1236005118,226008385,1009996733,2017.csv,2017,0.1828539232634472,0.8171460767365528
15,Minions,1159398397,336045770,823352627,2015.csv,2015,0.28984494964762314,0.7101550503523768
16,Captain America: Civil War,1153296293,408084349,745211944,2016.csv,2016,0.35384172434862754,0.6461582756513724
17,Aquaman,1148461807,335061807,813400000,2018.csv,2018,0.2917483236776023,0.7082516763223977
18,Spider-Man: Far from Home,1131927996,390532085,741395911,2019.csv,2019,0.345014953583673,0.654985046416327
19,Captain Marvel,1128274794,426829839,701444955,2019.csv,2019,0.3783030882811692,0.6216969117188308
20,Joker,1074251311,335451311,738800000,2019.csv,2019,0.3122652097931673,0.6877347902068327
21,Star Wars: Episode IX - The Rise of Skywalker,1074144248,515202542,558941706,2019.csv,2019,0.4796399952420543,0.5203600047579457
22,Toy Story 4,1073394593,434038008,639356585,2019.csv,2019,0.4043601587249657,0.5956398412750342
23,Rogue One: A Star Wars Story,1056057273,532177324,523879949,2016.csv,2016,0.5039284682810948,0.49607153171890517
24,Aladdin,1050693953,355559216,695134737,2019.csv,2019,0.3384041708670612,0.6615958291329388
25,Despicable Me 3,1034799409,264624300,770175109,2017.csv,2017,0.2557252136969475,0.7442747863030524
26,Finding Dory,1028570889,486295561,542275328,2016.csv,2016,0.47278759898871686,0.5272124010112832
27,Zootopia,1023784195,341268248,682515947,2016.csv,2016,0.3333400238709487,0.6666599761290513
28,The Jungle Book,966550600,364001123,602549477,2016.csv,2016,0.3765981036067848,0.6234018963932152
29,Jumanji: Welcome to the Jungle,962077546,404515480,557562066,2017.csv,2017,0.42046036900231326,0.5795396309976868
30,Bohemian Rhapsody,903655259,216428042,687227217,2018.csv,2018,0.23950288546929155,0.7604971145307085
31,Spectre,880674609,200074609,680600000,2015.csv,2015,0.22718335121207064,0.7728166487879293
32,Spider-Man: Homecoming,880166924,334201140,545965784,2017.csv,2017,0.37970199843592395,0.620298001564076
33,The Secret Life of Pets,875457937,368384330,507073607,2016.csv,2016,0.42079043941548044,0.5792095605845196
34,Batman v Superman: Dawn of Justice,873634919,330360194,543274725,2016.csv,2016,0.3781444477724682,0.6218555522275317
35,Wolf Warrior 2,870325439,2721100,867604339,2017.csv,2017,0.003126531614572282,0.9968734683854277
36,Guardians of the Galaxy Vol. 2,863756051,389813101,473942950,2017.csv,2017,0.4512999944240043,0.5487000055759956
37,Inside Out,857611174,356461711,501149463,2015.csv,2015,0.4156449004009829,0.5843550995990171
38,Venom,856085151,213515506,642569645,2018.csv,2018,0.24940919224050412,0.7505908077594958
39,Thor: Ragnarok,853977126,315058289,538918837,2017.csv,2017,0.36893059475225337,0.6310694052477467
40,Wonder Woman,821847012,412563408,409283604,2017.csv,2017,0.501995385973369,0.49800461402663104
41,Fantastic Beasts and Where to Find Them,814037575,234037575,580000000,2016.csv,2016,0.287502177034027,0.7124978229659731
42,Coco,807816196,210460015,597356181,2017.csv,2017,0.2605295809147159,0.7394704190852841
43,Jumanji: The Next Level,800059707,320314960,479744747,2019.csv,2019,0.4003638193467978,0.5996361806532021
44,Pirates of the Caribbean: Dead Men Tell No Tales,794861794,172558876,622302918,2017.csv,2017,0.21709293024593404,0.782907069754066
45,Mission: Impossible - Fallout,791115104,220159104,570956000,2018.csv,2018,0.27828959766643513,0.7217104023335649
46,Deadpool,782612155,363070709,419541446,2016.csv,2016,0.463921633059737,0.536078366940263
47,Fast & Furious Presents: Hobbs & Shaw,759056935,173956935,585100000,2019.csv,2019,0.22917508157671992,0.77082491842328
48,Suicide Squad,746846894,325100054,421746840,2016.csv,2016,0.43529678788488074,0.5647032121151193
49,Deadpool 2,734546611,318491426,416055185,2018.csv,2018,0.43358912998919275,0.5664108700108073
50,Ne Zha,726063471,3695533,722367938,2019.csv,2019,0.005089820859476899,0.9949101791405232
51,It,700381748,327481748,372900000,2017.csv,2017,0.4675760739555994,0.5324239260444006
52,The Wandering Earth,699856699,5971413,693885286,2019.csv,2019,0.008532336703402763,0.9914676632965972
53,Mission: Impossible - Rogue Nation,682714267,195042377,487671890,2015.csv,2015,0.2856866868434727,0.7143133131565274
54,Doctor Strange,677718395,232641920,445076475,2016.csv,2016,0.3432722524817996,0.6567277475182004
55,The Hunger Games: Mockingjay - Part 2,658344137,281723902,376620235,2015.csv,2015,0.4279280184430351,0.5720719815569649
56,Justice League,657924295,229024295,428900000,2017.csv,2017,0.3481012887660578,0.6518987112339422
57,Fantastic Beasts: The Crimes of Grindelwald,654855901,159555901,495300000,2018.csv,2018,0.24365039813545178,0.7563496018645482
58,Moana,643331111,248757044,394574067,2016.csv,2016,0.38667031602642327,0.6133296839735767
59,Sing,634151679,270395425,363756254,2016.csv,2016,0.42638919670825315,0.5736108032917469
60,The Martian,630161890,228433663,401728227,2015.csv,2015,0.36249996488997455,0.6375000351100255
61,Ant-Man and the Wasp,622674139,216648740,406025399,2018.csv,2018,0.3479327732285988,0.6520672267714012
62,Logan,619021436,226277068,392744368,2017.csv,2017,0.36553995522701094,0.6344600447729891
63,Transformers: The Last Knight,605425157,130168683,475256474,2017.csv,2017,0.21500375644284633,0.7849962435571537
64,Ready Player One,582890172,137690172,445200000,2018.csv,2018,0.23621975221774713,0.7637802477822528
65,Operation Red Sea,579330426,1543547,577786879,2018.csv,2018,0.0026643637736368433,0.9973356362263631
66,Fifty Shades of Grey,569651467,166167230,403484237,2015.csv,2015,0.2916998193212763,0.7083001806787237
67,Kong: Skull Island,566652812,168052812,398600000,2017.csv,2017,0.29657103686975084,0.7034289631302492
68,Mei ren yu,553810228,3232685,550577543,2016.csv,2016,0.005837170995693492,0.9941628290043065
69,Detective Chinatown 2,544185156,1983984,542201172,2018.csv,2018,0.0036457885301083076,0.9963542114698917
70,X-Men: Apocalypse,543934105,155442489,388491616,2016.csv,2016,0.285774485495812,0.7142255145041879
71,Cinderella,542351353,201151353,341200000,2015.csv,2015,0.3708875286976559,0.6291124713023442
72,The Revenant,532950503,183637894,349312609,2015.csv,2015,0.34456838480552104,0.6554316151944789
73,The Meg,530243742,145443742,384800000,2018.csv,2018,0.2742960085703378,0.7257039914296621
74,Ralph Breaks the Internet,529323962,201091711,328232251,2018.csv,2018,0.3799029052835511,0.6200970947164489
75,Hotel Transylvania 3: Summer Vacation,528583774,167510016,361073758,2018.csv,2018,0.31690343941583043,0.6830965605841696
76,The Boss Baby,527965936,175003033,352962903,2017.csv,2017,0.331466522870521,0.6685334771294791
77,Dunkirk,525245546,188045546,337200000,2017.csv,2017,0.3580145465907482,0.6419854534092517
78,How to Train Your Dragon: The Hidden World,521799505,160799505,361000000,2019.csv,2019,0.3081633912243746,0.6918366087756255
79,Kung Fu Panda 3,521170825,143528619,377642206,2016.csv,2016,0.2753964959569638,0.7246035040430362
80,Ant-Man,519311965,180202163,339109802,2015.csv,2015,0.3470017545234106,0.6529982454765894
81,The Grinch,511595957,270620950,240975007,2018.csv,2018,0.5289739809261237,0.4710260190738763
82,Maleficent: Mistress of Evil,491730089,113929605,377800484,2019.csv,2019,0.23169134358178353,0.7683086564182164
83,War for the Planet of the Apes,490719763,146880162,343839601,2017.csv,2017,0.2993157665019495,0.7006842334980505
84,Hotel Transylvania 2,474800000,169700110,305099890,2015.csv,2015,0.3574138795282224,0.6425861204717775
85,San Andreas,473990832,155190832,318800000,2015.csv,2015,0.32741315131597315,0.6725868486840269
86,It Chapter Two,473093228,211593228,261500000,2019.csv,2019,0.44725482310222375,0.5527451768977762
87,Bumblebee,467989645,127195589,340794056,2018.csv,2018,0.2717914602576303,0.7282085397423698
88,The Eight Hundred,461406887,372755,461034132,2020.csv,2020,0.0008078661383309608,0.999192133861669
89,Demon Slayer: Mugen Train,455495361,47700000,407795361,2020.csv,2020,0.10472115433904496,0.8952788456609551
90,Dying to Survive,451176639,0,451176639,2018.csv,2018,0.0,1.0
91,My People My Country,450064993,2356683,447708310,2019.csv,2019,0.005236317057878794,0.9947636829421213
92,La La Land,447407695,151101803,296305892,2016.csv,2016,0.3377273227274287,0.6622726772725712
93,Terminator Genisys,440603537,89760956,350842581,2015.csv,2015,0.20372273134974855,0.7962772686502514
94,Warcraft,439048914,47365290,391683624,2016.csv,2016,0.10788157877097038,0.8921184212290296
95,A Star Is Born,436188866,215288866,220900000,2018.csv,2018,0.4935679995096436,0.5064320004903564
96,The Greatest Showman,434993183,174340174,260653009,2017.csv,2017,0.4007882900546513,0.5992117099453488
97,Pokémon Detective Pikachu,433005346,144105346,288900000,2019.csv,2019,0.3328026947731957,0.6671973052268043
98,The Secret Life of Pets 2,430051293,158874395,271176898,2019.csv,2019,0.36943126921374003,0.63056873078626
99,Rampage,428028233,101028233,327000000,2018.csv,2018,0.2360317035441912,0.7639682964558088
100,Bad Boys for Life,426505244,206305244,220200000,2020.csv,2020,0.4837109200936343,0.5162890799063657
101,My People My Homeland,422390820,0,422390820,2020.csv,2020,0.0,1.0
102,The Captain,417282021,706572,416575449,2019.csv,2019,0.0016932720904359309,0.9983067279095641
103,Jason Bourne,415484914,162434410,253050504,2016.csv,2016,0.39095140287091146,0.6090485971290885
104,Kingsman: The Secret Service,414351546,128261724,286089822,2015.csv,2015,0.3095480763573644,0.6904519236426355
105,Kingsman: The Golden Circle,410902662,100234838,310667824,2017.csv,2017,0.24393815681826855,0.7560618431817314
106,The Mummy,409231607,80227895,329003712,2017.csv,2017,0.196045206742792,0.803954793257208
107,Ice Age: Collision Course,408579038,64063008,344516030,2016.csv,2016,0.15679465180981703,0.843205348190183
108,Alita: Battle Angel,404980543,85838210,319142333,2019.csv,2019,0.21195638033405473,0.7880436196659453
109,Mamma Mia! Here We Go Again,395044706,120634935,274409771,2018.csv,2018,0.3053703369967449,0.6946296630032551
110,Solo: A Star Wars Story,392924807,213767512,179157295,2018.csv,2018,0.5440417815106289,0.4559582184893712
111,Independence Day: Resurgence,389681935,103144286,286537649,2016.csv,2016,0.26468839516514925,0.7353116048348508
112,Monster Hunt,387053506,32766,387020740,2015.csv,2015,8.465496240718718e-05,0.9999153450375928
113,Godzilla: King of the Monsters,386600138,110500138,276100000,2019.csv,2019,0.2858253971963145,0.7141746028036855
114,Home,386041607,177397510,208644097,2015.csv,2015,0.45952950869360565,0.5404704913063944
115,1917,384623579,159227644,225395935,2019.csv,2019,0.41398305432543436,0.5860169456745656
116,Cars 3,383930656,152901115,231029541,2017.csv,2017,0.3982519046356121,0.6017480953643879
117,Fifty Shades Darker,381545846,114581250,266964596,2017.csv,2017,0.3003079477898444,0.6996920522101556
118,Spider-Man: Into the Spider-Verse,375540831,190241310,185299521,2018.csv,2018,0.5065795628491859,0.49342043715081413
119,Mad Max: Fury Road,374736354,153636354,221100000,2015.csv,2015,0.4099851865453118,0.5900148134546882
120,Once Upon a Time... In Hollywood,374375059,142502728,231872331,2019.csv,2019,0.3806416174748436,0.6193583825251564
121,Fifty Shades Freed,371985018,100407760,271577258,2018.csv,2018,0.26992420431298125,0.7300757956870187
122,Hello Mr. Billionaire,366961907,0,366961907,2018.csv,2018,0.0,1.0
123,Shazam!,365971656,140371656,225600000,2019.csv,2019,0.3835588185550632,0.6164411814449369
124,The Nun,365550119,117450119,248100000,2018.csv,2018,0.32129689718415877,0.6787031028158412
125,Tenet,363656624,58456624,305200000,2020.csv,2020,0.16074675983352912,0.8392532401664708
126,Monster Hunt 2,361682618,706153,360976465,2018.csv,2018,0.0019524106629862981,0.9980475893370137
127,Your Name.,357986087,5017246,352968841,2016.csv,2016,0.014015198305737508,0.9859848016942625
128,The Legend of Tarzan,356700357,126643061,230057296,2016.csv,2016,0.3550404660794887,0.6449595339205113
129,Dumbo,353284621,114766307,238518314,2019.csv,2019,0.32485508900768145,0.6751449109923185
130,Murder on the Orient Express,352789811,102826543,249963268,2017.csv,2017,0.29146687289106543,0.7085331271089346
131,The Angry Birds Movie,352333929,107509366,244824563,2016.csv,2016,0.3051348653964007,0.6948651346035993
132,Peter Rabbit,351266433,115253424,236013009,2018.csv,2018,0.3281082767165515,0.6718917232834485
133,Mary Poppins Returns,349537494,171958438,177579056,2018.csv,2018,0.4919599211865952,0.5080400788134047
134,Trolls,346864462,153707064,193157398,2016.csv,2016,0.44313292608223437,0.5568670739177656
135,xXx: Return of Xander Cage,346118277,44898413,301219864,2017.csv,2017,0.12971985585147242,0.8702801441485276
136,Star Trek Beyond,343471816,158848340,184623476,2016.csv,2016,0.462478528369268,0.537521471630732
137,A Quiet Place,340939361,188024361,152915000,2018.csv,2018,0.5514891576276522,0.44851084237234784
138,The Great Wall,334933831,45540830,289393001,2016.csv,2016,0.13596963276008986,0.8640303672399101
139,Now You See Me 2,334897606,65075540,269822066,2016.csv,2016,0.19431473630778956,0.8056852636922105
140,Never Say Die,334530869,0,334530869,2017.csv,2017,0.0,1.0
141,The Good Dinosaur,332207671,123087120,209120551,2015.csv,2015,0.3705125761530052,0.6294874238469947
142,Crazy Alien,327598891,0,327598891,2019.csv,2019,0.0,1.0
143,John Wick: Chapter 3 - Parabellum,326709727,171015687,155694040,2019.csv,2019,0.5234484096030603,0.47655159039693973
144,Taken 3,326479141,89256424,237222717,2015.csv,2015,0.27339089329446625,0.7266091067055338
145,The SpongeBob Movie: Sponge Out of Water,325186032,162994032,162192000,2015.csv,2015,0.5012331894993571,0.4987668105006429
146,Green Book,321752656,85080171,236672485,2018.csv,2018,0.26442725308847176,0.7355727469115282
147,The Conjuring 2,320392818,102470008,217922810,2016.csv,2016,0.31982617038562955,0.6801738296143705
148,Sonic the Hedgehog,319715683,148974665,170741018,2020.csv,2020,0.46595982906475064,0.5340401709352494
149,Maze Runner: The Scorch Trials,312296056,81697192,230598864,2015.csv,2015,0.2616017411375826,0.7383982588624174
150,Resident Evil: The Final Chapter,312242626,26830068,285412558,2016.csv,2016,0.085926986791355,0.914073013208645
151,The Lego Batman Movie,311950384,175750384,136200000,2017.csv,2017,0.5633921066114155,0.4366078933885845
152,Knives Out,311539397,165363234,146176163,2019.csv,2019,0.530793972102347,0.46920602789765303
153,The Ex-File 3: The Return of The Exes,307592427,838959,306753468,2017.csv,2017,0.002727502130603495,0.9972724978693965
154,Annabelle: Creation,306515884,102092201,204423683,2017.csv,2017,0.33307311734617967,0.6669268826538203
155,Wonder,305937718,132422809,173514909,2017.csv,2017,0.43284237676114196,0.5671576232388581
156,Skyscraper,304868961,68420120,236448841,2018.csv,2018,0.22442468323300382,0.7755753167669962
157,Dangal,303723636,12391761,291331875,2016.csv,2016,0.04079946217949267,0.9592005378205073
158,Passengers,303144152,100014699,203129453,2016.csv,2016,0.3299245535173642,0.6700754464826357
159,Alice Through the Looking Glass,299457024,77041381,222415643,2016.csv,2016,0.257270241889534,0.7427297581104659
160,Ocean's Eight,297718711,140218711,157500000,2018.csv,2018,0.47097715333048046,0.5290228466695195
161,The Divergent Series: Insurgent,297002527,130179072,166823455,2015.csv,2015,0.4383096444159211,0.5616903555840789
162,Miss Peregrine's Home for Peculiar Children,296482446,87242834,209239612,2016.csv,2016,0.29425969455203427,0.7057403054479657
163,Ferdinand,296069199,84410380,211658819,2017.csv,2017,0.28510355107894897,0.7148964489210511
164,Pacific Rim: Uprising,290930148,59874525,231055623,2018.csv,2018,0.20580378283793402,0.794196217162066
165,Maze Runner: The Death Cure,288175335,58032443,230142892,2018.csv,2018,0.2013789382772818,0.7986210617227182
166,Pitch Perfect 2,287144079,184296230,102847849,2015.csv,2015,0.6418249355578737,0.35817506444212627
167,Split,278454358,138291365,140162993,2017.csv,2017,0.4966392553281569,0.5033607446718431
168,Tomb Raider,274650803,58250803,216400000,2018.csv,2018,0.21209041577060309,0.7879095842293969
169,Terminator: Dark Fate,261119292,62253077,198866215,2019.csv,2019,0.23840856998034446,0.7615914300196556
170,Mojin: The Lost Legend,259368448,1243810,258124638,2015.csv,2015,0.004795533186827721,0.9952044668131723
171,Blade Runner 2049,259239658,92054159,167185499,2017.csv,2017,0.35509288860425825,0.6449071113957418
172,Parasite,258774734,53369749,205404985,2019.csv,2019,0.20624018494788598,0.793759815052114
173,Kung Fu Yoga,257743016,362657,257380359,2017.csv,2017,0.0014070487946800467,0.99859295120532
174,Lost in Hong Kong,256283912,1302281,254981631,2015.csv,2015,0.005081399725161055,0.9949186002748389
175,Pegasus,255863112,0,255863112,2019.csv,2019,0.0,1.0
176,Halloween,255485178,159342015,96143163,2018.csv,2018,0.6236839892136522,0.37631601078634785
177,Get Out,255407969,176040665,79367304,2017.csv,2017,0.6892528282858708,0.31074717171412924
178,Us,255184580,175084580,80100000,2019.csv,2019,0.6861095603817441,0.3138904396182559
179,Baahubali 2: The Conclusion,254158390,20186659,233971731,2017.csv,2017,0.07942550706274147,0.9205744929372586
180,Men in Black: International,253890701,80001807,173888894,2019.csv,2019,0.31510333653377876,0.6848966634662212
181,X-Men: Dark Phoenix,252442974,65845974,186597000,2019.csv,2019,0.26083504308580996,0.73916495691419
182,Journey to the West: The Demons Strike Back,247585244,880346,246704898,2017.csv,2017,0.0035557288704976295,0.9964442711295024
183,Glass,246999039,111048468,135950571,2019.csv,2019,0.44959068848846817,0.5504093115115318
184,The Peanuts Movie,246233113,130178411,116054702,2015.csv,2015,0.5286795484732388,0.47132045152676116
185,Teenage Mutant Ninja Turtles: Out of the Shadows,245623848,82051601,163572247,2016.csv,2016,0.3340538863311025,0.6659461136688974
186,Dolittle,245487753,77047065,168440688,2020.csv,2020,0.3138529888291413,0.6861470111708587
187,The Bravest,245179562,290217,244889345,2019.csv,2019,0.0011836916488169597,0.9988163083511831
188,Pixels,244874809,78747585,166127224,2015.csv,2015,0.3215830379677805,0.6784169620322195
189,Daddy's Home,242786137,150357137,92429000,2015.csv,2015,0.6192986916711806,0.38070130832881943
190,Alien: Covenant,240891763,74262031,166629732,2017.csv,2017,0.3082796608533269,0.6917203391466731
191,Sully,240797623,125070033,115727590,2016.csv,2016,0.5193989518742052,0.48060104812579485
192,Assassin's Creed,240697856,54647948,186049908,2016.csv,2016,0.2270396126835463,0.7729603873164537
193,Legend of Deification,240663149,214670,240448479,2020.csv,2020,0.0008919936471038197,0.9991080063528962
194,Crazy Rich Asians,238532921,174532921,64000000,2018.csv,2018,0.7316932198218459,0.2683067801781541
195,Hidden Figures,235956898,169607287,66349611,2016.csv,2016,0.7188062245164792,0.2811937754835207
196,Spy,235666219,110825712,124840507,2015.csv,2015,0.47026558354551445,0.5297344164544856
197,Alvin and the Chipmunks: The Road Chip,234798636,85886987,148911649,2015.csv,2015,0.3657899741802589,0.6342100258197412
198,Annabelle Comes Home,231252591,74152591,157100000,2019.csv,2019,0.32065626023623667,0.6793437397637634
199,Ghostbusters,229147509,128350574,100796935,2016.csv,2016,0.5601220565744837,0.43987794342551634
200,Goodbye Mr. Loser,228122928,1293626,226829302,2015.csv,2015,0.005670740820931423,0.9943292591790686
201,Paddington 2,227978523,40891591,187086932,2017.csv,2017,0.17936597913655225,0.8206340208634477
202,Youth,227091290,1891956,225199334,2017.csv,2017,0.00833125744276674,0.9916687425572333
203,Baby Driver,226945087,107825862,119119225,2017.csv,2017,0.47511873213628986,0.5248812678637101
204,Better Days,225918798,1921657,223997141,2019.csv,2019,0.008505963279779843,0.9914940367202202
205,Valerian and the City of a Thousand Planets,225874228,41189488,184684740,2017.csv,2017,0.18235585513545174,0.8176441448645483
206,Ford v Ferrari,225508210,117624357,107883853,2019.csv,2019,0.521596783549477,0.47840321645052303
207,Geostorm,221600160,33700160,187900000,2017.csv,2017,0.15207642449355632,0.8479235755064437
208,Inferno,220021259,34343574,185677685,2016.csv,2016,0.15609207108482184,0.8439079289151782
209,The Emoji Movie,217776646,86089513,131687133,2017.csv,2017,0.39531104267259215,0.6046889573274078
210,Central Intelligence,216972543,127440871,89531672,2016.csv,2016,0.5873594383783389,0.412640561621661
211,Little Women,216601214,108101214,108500000,2019.csv,2019,0.4990794465260938,0.5009205534739062
212,A Little Red Flower,216000000,0,216000000,2020.csv,2020,0.0,1.0
213,Ted 2,215863606,81476385,134387221,2015.csv,2015,0.37744382441197616,0.6225561755880239
214,Creed II,214215889,115715889,98500000,2018.csv,2018,0.5401835015142131,0.45981649848578693
215,Smallfoot,214040103,83240103,130800000,2018.csv,2018,0.3888995652370808,0.6111004347629192
216,Bridget Jones's Baby,211952420,24252420,187700000,2016.csv,2016,0.11442388815376583,0.8855761118462342
217,Us and Them,209221380,0,209221380,2018.csv,2018,0.0,1.0
218,Tomorrowland,209035668,93436322,115599346,2015.csv,2015,0.44698745861878464,0.5530125413812154
219,Me Before You,208314186,56245075,152069111,2016.csv,2016,0.2700011750519957,0.7299988249480043
220,London Has Fallen,205754447,62524260,143230187,2016.csv,2016,0.30387804935268303,0.696121950647317
221,A Dog's Purpose,205035819,64508620,140527199,2017.csv,2017,0.3146212223533489,0.6853787776466511
222,Everest,203427584,43482270,159945314,2015.csv,2015,0.2137481512831613,0.7862518487168387
223,Arrival,203388186,100546139,102842047,2016.csv,2016,0.49435584719753584,0.5056441528024641
224,The Addams Family,203044905,100044905,103000000,2019.csv,2019,0.49272305059809307,0.5072769494019069
225,Birds of Prey,201858461,84158461,117700000,2020.csv,2020,0.41691817416561006,0.5830818258343899
226,Straight Outta Compton,201634991,161197785,40437206,2015.csv,2015,0.7994534291917617,0.20054657080823834
227,Shock Wave 2,198914468,0,198914468,2020.csv,2020,0.0,1.0
228,The Island,198326350,670883,197655467,2018.csv,2018,0.0033827224672868736,0.9966172775327131
229,Christopher Robin,197744377,99215042,98529335,2018.csv,2018,0.5017338217409844,0.4982661782590157
230,Smurfs: The Lost Village,197183546,45020282,152163264,2017.csv,2017,0.22831662637814618,0.7716833736218538
231,The Shape of Water,195333312,63859435,131473877,2017.csv,2017,0.3269254708587545,0.6730745291412455
232,The BFG,195243411,55483770,139759641,2016.csv,2016,0.28417742609506036,0.7158225739049396
233,Rocketman,195179299,96368160,98811139,2019.csv,2019,0.4937417056713581,0.5062582943286419
234,The Intern,194564672,75764672,118800000,2015.csv,2015,0.38940610965591943,0.6105938903440805
235,Downton Abbey,193820755,96854135,96966620,2019.csv,2019,0.49970982209825776,0.5002901779017422
236,The Monkey King 2,193678298,709982,192968316,2016.csv,2016,0.003665779838689,0.996334220161311
237,Weathering with You,193485685,7798743,185686942,2019.csv,2019,0.04030656324781857,0.9596934367521814
238,The Lego Movie 2: The Second Part,192306508,105806508,86500000,2019.csv,2019,0.5501972299346208,0.44980277006537916
239,Sheep Without a Shepherd,191602146,0,191602146,2019.csv,2019,0.0,1.0
240,The Equalizer 2,190400157,102084362,88315795,2018.csv,2018,0.5361569213411941,0.4638430786588059
241,The White Storm 2: Drug Lords,189396380,609461,188786919,2019.csv,2019,0.003217912612690908,0.9967820873873091
242,Project Gutenberg,188116796,0,188116796,2018.csv,2018,0.0,1.0
243,Jian Bing Man,186683536,0,186683536,2015.csv,2015,0.0,1.0
244,Pitch Perfect 3,185400345,104897530,80502815,2017.csv,2017,0.5657892923554161,0.4342107076445839
245,Bad Moms,183936074,113257297,70678777,2016.csv,2016,0.615742711785835,0.3842572882141651
246,Jupiter Ascending,183887723,47387723,136500000,2015.csv,2015,0.25769922117095334,0.7423007788290467
247,Storks,183388953,72679278,110709675,2016.csv,2016,0.3963121922616571,0.6036878077383429
248,From Vegas to Macau III,181732879,0,181732879,2016.csv,2016,0.0,1.0
249,Daddy's Home 2,180613180,104029443,76583737,2017.csv,2017,0.5759792447040687,0.42402075529593136
250,Hacksaw Ridge,180563636,67209615,113354021,2016.csv,2016,0.37222120959061766,0.6277787904093823
251,The Post,179769457,81903458,97865999,2017.csv,2017,0.4556027445752367,0.5443972554247632
252,Allegiant,179246868,66184051,113062817,2016.csv,2016,0.36923407219589466,0.6307659278041053
253,Abominable,179053956,60716390,118337566,2019.csv,2019,0.33909549588505045,0.6609045041149496
254,Baywatch,177856751,58060186,119796565,2017.csv,2017,0.32644353207599075,0.6735564679240093
255,The Hitman's Bodyguard,176586701,75468583,101118118,2017.csv,2017,0.4273741033306919,0.5726258966693081
256,Ip Man 4: The Finale,176345966,3956031,172389935,2019.csv,2019,0.02243335126815433,0.9775666487318456
257,The Mule,174804407,103804407,71000000,2018.csv,2018,0.5938317504775494,0.40616824952245056
258,The Croods: A New Age,174489000,58569000,115920000,2020.csv,2020,0.33566012757251174,0.6643398724274883
259,The Nutcracker and the Four Realms,173961069,54858851,119102218,2018.csv,2018,0.3153513100106323,0.6846486899893677
260,Operation Mekong,173839072,800012,173039060,2016.csv,2016,0.004602026407504062,0.9953979735924959
261,Creed,173567581,109767581,63800000,2015.csv,2015,0.6324198353608442,0.3675801646391557
262,Gemini Man,173469516,48546770,124922746,2019.csv,2019,0.27985764369112553,0.7201423563088745
263,The Girl on the Train,173185859,75395035,97790824,2016.csv,2016,0.435341750390833,0.564658249609167
264,Spies in Disguise,171616764,66757013,104859751,2019.csv,2019,0.3889888810629246,0.6110111189370754
265,John Wick: Chapter 2,171539887,92029184,79510703,2017.csv,2017,0.5364885427492441,0.46351145725075593
266,Ghost in the Shell,169801921,40563557,129238364,2017.csv,2017,0.23888750351652382,0.7611124964834762
267,Insidious: The Last Key,167885588,67745330,100140258,2018.csv,2018,0.40352081919026905,0.596479180809731
268,Fantastic Four,167882881,56117548,111765333,2015.csv,2015,0.3342660530110869,0.6657339469889131
269,Wonder Woman 1984,166534027,46534027,120000000,2020.csv,2020,0.2794265402589466,0.7205734597410534
270,Bridge of Spies,165478348,72313754,93164594,2015.csv,2015,0.4369982833041094,0.5630017166958906
271,The Huntsman: Winter's War,164989338,48390190,116599148,2016.csv,2016,0.2932928308373478,0.7067071691626522
272,From Vegas to Macau II,163877532,0,163877532,2015.csv,2015,0.0,1.0
273,The Magnificent Seven,162360636,93432655,68927981,2016.csv,2016,0.5754637164638847,0.4245362835361152
274,Jack Reacher: Never Go Back,162146076,58697076,103449000,2016.csv,2016,0.36200121179620776,0.6379987882037922
275,The Sacrifice,161047608,0,161047608,2020.csv,2020,0.0,1.0
276,The Predator,160542134,51024708,109517426,2018.csv,2018,0.3178275181018835,0.6821724818981165
277,Three Billboards Outside Ebbing Missouri,160192031,54513740,105678291,2017.csv,2017,0.3403024461310438,0.6596975538689562
278,Johnny English Strikes Again,158970776,4412170,154558606,2018.csv,2018,0.02775459811556811,0.9722454018844319
279,Focus,158762963,53862963,104900000,2015.csv,2015,0.3392665517334795,0.6607334482665205
280,Goosebumps,158260952,80080379,78180573,2015.csv,2015,0.5060021312142745,0.4939978687857255
281,Don't Breathe,157830487,89217875,68612612,2016.csv,2016,0.565276561555563,0.4347234384444369
282,Hustlers,157563598,104963598,52600000,2019.csv,2019,0.6661665469203109,0.33383345307968915
283,Ip Man 3,156954938,2679437,154275501,2015.csv,2015,0.01707137751855886,0.9829286224814411
284,The Climbers,156892866,487157,156405709,2019.csv,2019,0.0031050296448788183,0.9968949703551212
285,The Hateful Eight,155760117,54117416,101642701,2015.csv,2015,0.3474407765114866,0.6525592234885135
286,Escape Room,155712077,57005601,98706476,2019.csv,2019,0.36609620845273294,0.6339037915472671
287,The Accountant,155160045,86260045,68900000,2016.csv,2016,0.5559423819450426,0.44405761805495736
288,Monkey King: Hero Is Back,153262397,0,153262397,2015.csv,2015,0.0,1.0
289,Yesterday,153178480,73286650,79891830,2019.csv,2019,0.4784395954314209,0.5215604045685791
290,Duckweed,152894264,471575,152422689,2017.csv,2017,0.0030843210704098096,0.9969156789295902
291,Red Sparrow,151572634,46874505,104698129,2018.csv,2018,0.30925440670246584,0.6907455932975342
292,Darkest Hour,150847207,56468410,94378797,2017.csv,2017,0.37434176689794463,0.6256582331020554
293,Gods of Egypt,150680864,31153464,119527400,2015.csv,2015,0.20675129656808977,0.7932487034319102
294,Lights Out,148868835,67268835,81600000,2016.csv,2016,0.4518664702387172,0.5481335297612828
295,King Arthur: Legend of the Sword,148675066,39175066,109500000,2017.csv,2017,0.2634945257061463,0.7365054742938537
296,The Angry Birds Movie 2,147792047,41667116,106124931,2019.csv,2019,0.2819307049722371,0.7180692950277628
297,The Last Witch Hunter,146936910,27367660,119569250,2015.csv,2015,0.18625449521158435,0.8137455047884157
298,Angel Has Fallen,146661977,69030436,77631541,2019.csv,2019,0.470677113537069,0.529322886462931
299,Time Raiders,145819137,0,145819137,2016.csv,2016,0.0,1.0
300,The Foreigner,145374099,34393507,110980592,2017.csv,2017,0.23658620921186244,0.7634137907881375
301,Pete's Dragon,143695338,76233151,67462187,2016.csv,2016,0.5305193060612725,0.4694806939387275
302,The Invisible Man,143151000,70410000,72741000,2020.csv,2020,0.49185824758471824,0.5081417524152818
303,More Than Blue,142958164,722669,142235495,2018.csv,2018,0.005055108290282743,0.9949448917097172
304,Power Rangers,142337240,85364450,56972790,2017.csv,2017,0.5997337731151735,0.4002662268848265
305,Onward,141950121,61555145,80394976,2020.csv,2020,0.43363925698943223,0.5663607430105678
306,Trainwreck,140795793,110212700,30583093,2015.csv,2015,0.7827840424180856,0.2172159575819144
307,Sausage Party,140705322,97685686,43019636,2016.csv,2016,0.6942572221966131,0.3057427778033869
308,Girls Trip,140552359,115171585,25380774,2017.csv,2017,0.8194212165446473,0.18057878345535275
309,Lion,140312928,51738905,88574023,2016.csv,2016,0.3687394008341127,0.6312605991658873
310,Mr. Six,139191345,1415450,137775895,2015.csv,2015,0.010169094924688026,0.989830905075312
311,The First Purge,137056262,69488745,67567517,2018.csv,2018,0.5070089026650968,0.49299109733490326
312,How Long Will I Love U,136796719,746933,136049786,2018.csv,2018,0.005460167505918033,0.994539832494082
313,Skiptrace,136579287,0,136579287,2016.csv,2016,0.0,1.0
314,American Made,134866593,51342000,83524593,2017.csv,2017,0.3806873063072039,0.6193126936927961
315,Point Break,133718711,28782481,104936230,2015.csv,2015,0.21524647362178057,0.7847535263782194
316,The Big Short,133440870,70259870,63181000,2015.csv,2015,0.5265243699325401,0.47347563006745985
317,A Wrinkle in Time,132675864,100478608,32197256,2018.csv,2018,0.7573239394921144,0.2426760605078856
318,The House with a Clock in Its Walls,131457147,68549695,62907452,2018.csv,2018,0.521460388912898,0.478539611087102
319,A Bad Moms Christmas,130560428,72110659,58449769,2017.csv,2017,0.5523163496369665,0.4476836503630334
320,Warm Hug,129240236,0,129240236,2020.csv,2020,0.0,1.0
321,Pan,128388320,35088320,93300000,2015.csv,2015,0.2732983810365304,0.7267016189634695
322,Ad Astra,127461872,50188370,77273502,2019.csv,2019,0.393752023350167,0.606247976649833
323,Midway,127420861,56846802,70574059,2019.csv,2019,0.4461341852022174,0.5538658147977826
324,The Upside,125852517,108252517,17600000,2019.csv,2019,0.860153770305603,0.13984622969439697
325,Detective Chinatown,125842935,474252,125368683,2015.csv,2015,0.003768602504383738,0.9962313974956163
326,Wolf Totem,125837070,210591,125626479,2015.csv,2015,0.0016735211651065938,0.9983264788348934
327,Mechanic: Resurrection,125729635,21218403,104511232,2016.csv,2016,0.1687621458536804,0.8312378541463196
328,Happy Death Day,125479266,55683845,69795421,2017.csv,2017,0.44376929173302626,0.5562307082669737
329,Captain Underpants: The First Epic Movie,125427681,73921000,51506681,2017.csv,2017,0.5893515642691345,0.4106484357308655
330,Ride Along 2,124605297,91221830,33383467,2015.csv,2015,0.7320862932496361,0.2679137067503639
331,The Curse of la Llorona,123133739,54733739,68400000,2019.csv,2019,0.4445064321485438,0.5554935678514562
332,The Lego Ninjago Movie,123081555,59281555,63800000,2017.csv,2017,0.4816445079849698,0.5183554920150302
333,Looking Up,122994583,84267,122910316,2019.csv,2019,0.0006851277344466463,0.9993148722655534
334,Zombieland: Double Tap,122810399,73123082,49687317,2019.csv,2019,0.5954144160056023,0.40458558399439776
335,Dragon Blade,122593849,74068,122519781,2015.csv,2015,0.0006041738684621934,0.9993958261315378
336,Secret Superstar,122026260,0,122026260,2017.csv,2017,0.0,1.0
337,Deepwater Horizon,121790373,61433527,60356846,2016.csv,2016,0.5044202221139433,0.4955797778860567
338,Last Christmas,121550750,35150750,86400000,2019.csv,2019,0.2891857927655732,0.7108142072344268
339,Instant Family,120556201,67363237,53192964,2018.csv,2018,0.5587704028596588,0.4412295971403412
340,The Commuter,119942387,36343858,83598529,2017.csv,2017,0.3030109614210029,0.6969890385789971
341,Extreme Job,119932733,1565885,118366848,2019.csv,2019,0.013056360518358236,0.9869436394816418
342,Dora and the Lost City of Gold,119682635,60477943,59204692,2019.csv,2019,0.505319280445321,0.4946807195546789
343,Wonder Park,119559110,45216793,74342317,2019.csv,2019,0.37819613244026323,0.6218038675597368
344,Allied,119520023,40098064,79421959,2016.csv,2016,0.33549243878575896,0.664507561214241
345,Soul,119198268,0,119198268,2020.csv,2020,0.0,1.0
346,I Belonged to You,119107580,744541,118363039,2016.csv,2016,0.006250995948368693,0.9937490040516314
347,The Shallows,119100758,55124043,63976715,2016.csv,2016,0.46283536667331704,0.537164633326683
348,Forever Young,119055731,0,119055731,2017.csv,2017,0.0,1.0
349,The Purge: Election Year,118587880,79213375,39374505,2016.csv,2016,0.6679719293405025,0.3320280706594974
350,A Cool Fish,118153135,551876,117601259,2018.csv,2018,0.004670853634141828,0.9953291463658581
351,Why Him?,118102725,60323786,57778939,2016.csv,2016,0.5107738707976467,0.4892261292023533
352,P Storm,117991727,326711,117665016,2019.csv,2019,0.0027689314183866466,0.9972310685816134
353,Magic Mike XXL,117813057,66013057,51800000,2015.csv,2015,0.5603203811271954,0.43967961887280455
354,Game Night,117679066,69179066,48500000,2018.csv,2018,0.5878621266419637,0.41213787335803637
355,Dragon Ball Super: Broly,115757940,30712119,85045821,2018.csv,2018,0.26531328218176653,0.7346867178182335
356,Detective Conan: The Fist of Blue Sapphire,115570314,0,115570314,2019.csv,2019,0.0,1.0
357,The Gentlemen,115171795,36471795,78700000,2019.csv,2019,0.31667297535824634,0.6833270246417537
358,The Monkey King 3,115084576,187074,114897502,2018.csv,2018,0.0016255349457081026,0.998374465054292
359,Finding Mr Right 2,114679097,0,114679097,2016.csv,2016,0.0,1.0
360,Office Christmas Party,114501299,54767494,59733805,2016.csv,2016,0.47831329843690246,0.5216867015630976
361,The Dark Tower,113231078,50701325,62529753,2017.csv,2017,0.44776863291895885,0.5522313670810411
362,Pet Sematary,113118226,54724696,58393530,2019.csv,2019,0.4837831880425706,0.5162168119574294
363,Insidious: Chapter 3,112983889,52218558,60765331,2015.csv,2015,0.46217702773534375,0.5378229722646563
364,Boonie Bears: Blast Into the Past,112369259,0,112369259,2019.csv,2019,0.0,1.0
365,How to Be Single,112343513,46843513,65500000,2016.csv,2016,0.4169667811616324,0.5830332188383677
366,Get Hard,111711453,90411453,21300000,2015.csv,2015,0.809330203591569,0.19066979640843093
367,The Call of the Wild,111105497,62342368,48763129,2020.csv,2020,0.5611096631879519,0.4388903368120481
368,Good Boys,111037232,83140306,27896926,2019.csv,2019,0.748760613917321,0.251239386082679
369,10 Cloverfield Lane,110216998,72082998,38134000,2016.csv,2016,0.6540098107190326,0.34599018928096736
370,Buddies in India,110155128,293194,109861934,2017.csv,2017,0.002661646401064506,0.9973383535989355
371,The 5th Wave,109906372,34916787,74989585,2015.csv,2015,0.3176957474312772,0.6823042525687227
372,Along With the Gods: The Two Worlds,109383972,1908823,107475149,2017.csv,2017,0.017450664526974757,0.9825493354730253
373,Neighbors 2: Sorority Rising,108007109,55455765,52551344,2016.csv,2016,0.5134455084803723,0.48655449151962765
374,Paul Blart: Mall Cop 2,107588225,71038190,36550035,2015.csv,2015,0.6602784830774929,0.33972151692250707
375,Vacation,107228221,58884188,48344033,2015.csv,2015,0.5491482321617552,0.45085176783824477
376,The Man from U.N.C.L.E.,107045109,45445109,61600000,2015.csv,2015,0.42454166682197503,0.575458333178025
377,Chronicles of the Ghostly Tribe,106380000,0,106380000,2015.csv,2015,0.0,1.0
378,Shaun the Sheep Movie,106209378,19375982,86833396,2015.csv,2015,0.18243193176406702,0.817568068235933
379,First Man,105697415,44936545,60760870,2018.csv,2018,0.4251432733714443,0.5748567266285557
380,Sisters,105011053,87044645,17966408,2015.csv,2015,0.8289093625220576,0.17109063747794245
381,Scary Stories to Tell in the Dark,104545505,68947075,35598430,2019.csv,2019,0.6594934425922951,0.3405065574077049
382,Book Club,104438188,68566296,35871892,2018.csv,2018,0.6565251400187065,0.34347485998129346
383,The Tales of Wukong,103818506,0,103818506,2017.csv,2017,0.0,1.0
384,Cold War II,103197501,560824,102636677,2016.csv,2016,0.00543447268165922,0.9945655273183408
385,Night School,103105878,77339130,25766748,2018.csv,2018,0.75009428657404,0.24990571342596005
386,Jigsaw,102952888,38052832,64900056,2017.csv,2017,0.3696140316141496,0.6303859683858505
387,Chappie,102811889,31569268,71242621,2015.csv,2015,0.3070585348354022,0.6929414651645979
388,Railroad Tigers,102205175,218044,101987131,2016.csv,2016,0.002133394908819441,0.9978666050911805
389,Detective Conan: Zero the Enforcer,101860359,0,101860359,2018.csv,2018,0.0,1.0
390,Joy,101134059,56451232,44682827,2015.csv,2015,0.5581822044737669,0.4418177955262332
391,Life,100541806,30234022,70307784,2017.csv,2017,0.30071095003008,0.69928904996992
392,Atomic Blonde,100014025,51687870,48326155,2017.csv,2017,0.5168062179279356,0.48319378207206437
393,Black Mass,99775678,62575678,37200000,2015.csv,2015,0.6271636460340565,0.3728363539659435
394,Line Walker 2: Invisible Spy,99482027,296751,99185276,2019.csv,2019,0.002982960932229497,0.9970170390677705
395,Spotlight,98690254,45055776,53634478,2015.csv,2015,0.45653723821604514,0.5434627617839549
396,Devil and Angel,98599942,131058,98468884,2015.csv,2015,0.0013291894228497619,0.9986708105771502
397,The Visit,98450062,65206105,33243957,2015.csv,2015,0.6623267032579421,0.3376732967420579
398,Alpha,98203196,35857181,62346015,2018.csv,2018,0.36513252582940375,0.6348674741705962
399,Along With the Gods: The Last 49 Days,97962238,1200246,96761992,2018.csv,2018,0.012252129233715547,0.9877478707662845
400,A Simple Favor,97644617,53548586,44096031,2018.csv,2018,0.5484028474401206,0.4515971525598795
401,The Little Prince,97571250,1339152,96232098,2015.csv,2015,0.013724862600407395,0.9862751373995926
402,Legend of the Demon Cat,97051623,0,97051623,2017.csv,2017,0.0,1.0
403,The Shack,96942115,57386418,39555697,2017.csv,2017,0.5919658138261168,0.40803418617388326
404,Boonie Bears 5,96820519,0,96820519,2018.csv,2018,0.0,1.0
405,Assassination,96119773,1904682,94215091,2015.csv,2015,0.019815714712518098,0.9801842852874819
406,The Favourite,95918706,34366783,61551923,2018.csv,2018,0.35829072798375744,0.6417092720162426
407,Qing sheng,95721320,100026,95621294,2016.csv,2016,0.001044970963626494,0.9989550290363735
408,The New King of Comedy,95618308,0,95618308,2019.csv,2019,0.0,1.0
409,Poltergeist,95437994,47425125,48012869,2015.csv,2015,0.49692080703205055,0.5030791929679495
410,Truth or Dare,95330493,41411015,53919478,2018.csv,2018,0.43439421843753606,0.565605781562464
411,The Hustle,95017038,35417038,59600000,2019.csv,2019,0.3727440756467277,0.6272559243532723
412,Adoring,94975692,0,94975692,2019.csv,2019,0.0,1.0
413,Kill Mobile,94870905,0,94870905,2018.csv,2018,0.0,1.0
414,I Feel Pretty,94539426,48795601,45743825,2018.csv,2018,0.5161402291568811,0.48385977084311893
415,Veteran,94393020,1200627,93192393,2015.csv,2015,0.01271944684045494,0.9872805531595451
416,Dirty Grandpa,94073028,35593113,58479915,2016.csv,2016,0.378356195784407,0.6216438042155931
417,Ben-Hur,94061311,26410477,67650834,2016.csv,2016,0.2807793844166174,0.7192206155833827
418,Blockers,94017294,60311495,33705799,2018.csv,2018,0.6414936277574634,0.35850637224253656
419,In the Heart of the Sea,93920758,25020758,68900000,2015.csv,2015,0.26640285420183685,0.7335971457981632
420,Kill Zone 2,93638358,11998,93626360,2015.csv,2015,0.00012813125151126635,0.9998718687484888
421,BlacKkKlansman,93400823,49275340,44125483,2018.csv,2018,0.5275685847008008,0.47243141529919924
422,Goosebumps 2: Haunted Halloween,93320380,46700633,46619747,2018.csv,2018,0.5004333780038187,0.49956662199618135
423,Money Monster,93282604,41012075,52270529,2016.csv,2016,0.43965405382551287,0.5603459461744872
424,Train to Busan,92742323,2129768,90612555,2016.csv,2016,0.022964359001445327,0.9770356409985547
425,Southpaw,91970827,52421953,39548874,2015.csv,2015,0.5699845778270538,0.4300154221729462
426,Shadow,91708374,521396,91186978,2018.csv,2018,0.005685369582498541,0.9943146304175015
427,Crawl,91542097,39014193,52527904,2019.csv,2019,0.4261885436161682,0.5738114563838318
428,Five Feet Apart,91522094,45729221,45792873,2019.csv,2019,0.49965225883052894,0.500347741169471
429,Rambo: Last Blood,91490353,44819352,46671001,2019.csv,2019,0.4898806325514997,0.5101193674485003
430,Overboard,91244913,50316123,40928790,2018.csv,2018,0.551440308787406,0.448559691212594
431,My Big Fat Greek Wedding 2,90632641,59689605,30943036,2016.csv,2016,0.6585883887020351,0.34141161129796493
432,Sherlock Gnomes,90497778,43242871,47254907,2018.csv,2018,0.4778335110062039,0.522166488993796
433,Jojo Rabbit,90335025,33370906,56964119,2019.csv,2019,0.369412705647671,0.630587294352329
434,Detective Dee: The Four Heavenly Kings,90040771,262963,89777808,2018.csv,2018,0.0029204880975530517,0.9970795119024469
435,Collateral Beauty,88528280,31016021,57512259,2016.csv,2016,0.350351559976089,0.649648440023911
436,Line Walker,88228755,0,88228755,2016.csv,2016,0.0,1.0
437,Chasing the Dragon,87965942,456854,87509088,2017.csv,2017,0.005193532742478902,0.9948064672575211
438,Tiger Zinda Hai,87320000,5560921,81759079,2017.csv,2017,0.06368439074667888,0.9363156092533211
439,Sultan,87280000,6200000,81080000,2016.csv,2016,0.07103574702108158,0.9289642529789184
440,Hello Mrs. Money,86874070,0,86874070,2018.csv,2018,0.0,1.0
441,Robin Hood,86489031,30824628,55664403,2018.csv,2018,0.35639927564918605,0.643600724350814
442,A Taxi Driver,86252940,1527829,84725111,2017.csv,2017,0.01771335562590678,0.9822866443740932
443,War Dogs,86234523,43034523,43200000,2016.csv,2016,0.4990405408747956,0.5009594591252045
444,I Can Only Imagine,86086881,83482352,2604529,2018.csv,2018,0.9697453436604353,0.030254656339564676
445,The Second Best Exotic Marigold Hotel,85978266,33078266,52900000,2015.csv,2015,0.38472822887588826,0.6152717711241118
446,Paper Towns,85512300,32000304,53511996,2015.csv,2015,0.37421872642882953,0.6257812735711704
447,Big Fish & Begonia,85409373,0,85409373,2016.csv,2016,0.0,1.0
448,Nerve,85251425,38583626,46667799,2016.csv,2016,0.4525862881470896,0.5474137118529103
449,Hidden Man,85170581,0,85170581,2018.csv,2018,0.0,1.0
450,Going in Style,84918541,45018541,39900000,2017.csv,2017,0.5301379471416025,0.46986205285839755
451,Sicario,84872444,46889293,37983151,2015.csv,2015,0.5524678068655593,0.44753219313444065
452,Leap!,84197417,2844490,81352927,2016.csv,2016,0.0337835779451524,0.9662164220548476
453,Our Times,83867493,0,83867493,2015.csv,2015,0.0,1.0
454,Mortal Engines,83672673,15951040,67721633,2018.csv,2018,0.19063619492591088,0.8093638050740891
455,Rings,83080890,27793018,55287872,2017.csv,2017,0.33452961324800445,0.6654703867519955
456,Suck Me Shakespeer 2,83027924,0,83027924,2015.csv,2015,0.0,1.0
457,Once Upon A Time,82886178,485728,82400450,2017.csv,2017,0.005860180933906736,0.9941398190660933
458,Hitman: Agent 47,82347656,22467450,59880206,2015.csv,2015,0.2728365455842483,0.7271634544157517
459,Ouija: Origin of Evil,81705746,35144505,46561241,2016.csv,2016,0.43013504827432825,0.5698649517256718
460,One Piece: Stampede,81562741,1298528,80264213,2019.csv,2019,0.01592060276640286,0.9840793972335972
461,Wolf Warrior,81411331,0,81411331,2015.csv,2015,0.0,1.0
462,Partment: The Movie,81096321,0,81096321,2018.csv,2018,0.0,1.0
463,Underworld: Blood Wars,81093313,30353973,50739340,2016.csv,2016,0.37430919858953104,0.625690801410469
464,Doraemon the Movie: Nobita's Treasure Island,80920916,0,80920916,2018.csv,2018,0.0,1.0
465,A Dog's Way Home,80708134,42004346,38703788,2019.csv,2019,0.5204474929379485,0.4795525070620515
466,Go Away Mr. Tumor,80606893,286639,80320254,2015.csv,2015,0.0035560110225312867,0.9964439889774687
467,Caught in Time,80543319,0,80543319,2020.csv,2020,0.0,1.0
468,Den of Thieves,80509622,44947622,35562000,2018.csv,2018,0.5582888216764947,0.44171117832350526
469,Hereditary,80200936,44069456,36131480,2018.csv,2018,0.5494880508626483,0.4505119491373517
470,The Wedding Ringer,79799880,64460211,15339669,2015.csv,2015,0.8077732823658381,0.19222671763416185
471,Paradox,79226860,0,79226860,2017.csv,2017,0.0,1.0
472,Manchester by the Sea,78988148,47695371,31292777,2016.csv,2016,0.603829463124012,0.396170536875988
473,Lady Bird,78965611,48958273,30007338,2017.csv,2017,0.6199948608008617,0.3800051391991382
474,Paranormal Activity: The Ghost Dimension,78903124,18300124,60603000,2015.csv,2015,0.2319315519116835,0.7680684480883165
475,The Boss,78844582,63285885,15558697,2016.csv,2016,0.8026662504216207,0.1973337495783794
476,Code Blue the Movie,78778562,0,78778562,2018.csv,2018,0.0,1.0
477,Tag,78130625,54730625,23400000,2018.csv,2018,0.7005015638874001,0.2994984361125999
478,The Left Ear,78015473,0,78015473,2015.csv,2015,0.0,1.0
479,Shin Godzilla,77947607,1918403,76029204,2016.csv,2016,0.024611441888139043,0.975388558111861
480,Tiny Times 4.0,77750000,0,77750000,2015.csv,2015,0.0,1.0
481,Fantastica: A Boonie Bears Adventure,77151096,0,77151096,2017.csv,2017,0.0,1.0
482,Mike and Dave Need Wedding Dates,77068246,46009673,31058573,2016.csv,2016,0.596999093504736,0.40300090649526393
483,Sanju,76693052,7909317,68783735,2018.csv,2018,0.10312951165380665,0.8968704883461933
484,Cold Pursuit,76419755,32138862,44280893,2019.csv,2019,0.42055698817668286,0.5794430118233171
485,Kubo and the Two Strings,76249438,48023088,28226350,2016.csv,2016,0.6298156322148892,0.37018436778511077
486,Vice,76073488,47836282,28237206,2018.csv,2018,0.6288167304751426,0.3711832695248573
487,Widows,75984700,42402632,33582068,2018.csv,2018,0.5580417110286676,0.4419582889713324
488,Quo vado?,75878701,0,75878701,2016.csv,2016,0.0,1.0
489,Sicario: Day of the Soldado,75837743,50072235,25765508,2018.csv,2018,0.6602548153364743,0.33974518466352566
490,A Dog's Journey,75741734,22782371,52959363,2019.csv,2019,0.30079019579879174,0.6992098042012083
491,Bajrangi Bhaijaan,75547184,8178001,67369183,2015.csv,2015,0.10825024265629808,0.8917497573437019
492,Searching,75462037,26020957,49441080,2018.csv,2018,0.3448218208050758,0.6551781791949242
493,The Spy Who Dumped Me,75320680,33562069,41758611,2018.csv,2018,0.4455890334500432,0.5544109665499568
494,Animal World,74922830,0,74922830,2018.csv,2018,0.0,1.0
495,Boo! A Madea Halloween,74827344,73206343,1621001,2016.csv,2016,0.9783367828744529,0.021663217125547047
496,A Madea Family Funeral,74747725,73257045,1490680,2019.csv,2019,0.9800571856869222,0.019942814313077754
497,Miracles from Heaven,73983003,61705123,12277880,2016.csv,2016,0.8340445845378837,0.16595541546211634
498,Cats,73833459,27166770,46666689,2019.csv,2019,0.3679465972195614,0.6320534027804386
499,Charlie's Angels,73279888,17803077,55476811,2019.csv,2019,0.24294629107511737,0.7570537089248827
500,War Room,73267874,67790117,5477757,2015.csv,2015,0.9252365777666758,0.07476342223332426
501,The Transporter Refueled,72629670,16029670,56600000,2015.csv,2015,0.22070415575342694,0.779295844246573
502,Amazing China,72506343,0,72506343,2018.csv,2018,0.0,1.0
503,Doctor Sleep,72381712,31581712,40800000,2019.csv,2019,0.4363217051290525,0.5636782948709476
504,Serial (Bad) Weddings 2,72300780,0,72300780,2019.csv,2019,0.0,1.0
505,Second Act,72282227,39282227,33000000,2018.csv,2018,0.5434562357908536,0.45654376420914644
506,What Men Want,72216294,54611903,17604391,2019.csv,2019,0.7562268841987377,0.24377311580126224
507,Run All Night,71561644,26461644,45100000,2015.csv,2015,0.3697741208963841,0.6302258791036159
508,I Am Not Madame Bovary,70826207,436798,70389409,2016.csv,2016,0.006167180461887504,0.9938328195381125
509,Spirited Away 2018 Re-release,70186029,1175067,69010962,2018.csv,2018,0.016742178133485795,0.9832578218665142
510,Bai du ren,70065569,0,70065569,2016.csv,2016,0.0,1.0
511,After,69756455,12138565,57617890,2019.csv,2019,0.1740135016895569,0.8259864983104431
512,Exit,69501772,470699,69031073,2019.csv,2019,0.006772474808268198,0.9932275251917319
513,Playing with Fire,69412425,44451847,24960578,2019.csv,2019,0.6404018732957392,0.3595981267042608
514,13 Hours,69411370,52853219,16558151,2015.csv,2015,0.7614490104431018,0.23855098955689824
515,Running Man,68782475,310978,68471497,2015.csv,2015,0.004521180722269735,0.9954788192777303
516,The Nut Job 2: Nutty by Nature,68743485,28370522,40372963,2017.csv,2017,0.41270124725273966,0.5872987527472603
517,The Yin-Yang Master: Dream of Eternity,68000000,0,68000000,2020.csv,2020,0.0,1.0
518,Shoplifters,67999335,3313513,64685822,2018.csv,2018,0.04872860889007223,0.9512713911099278
519,A Beautiful Day in the Neighborhood,67760877,61704055,6056822,2019.csv,2019,0.9106147637374882,0.08938523626251177
520,12 Strong,67450815,45819713,21631102,2018.csv,2018,0.6793055502739292,0.32069444972607075
521,American Assassin,67234188,36249674,30984514,2017.csv,2017,0.5391553773208356,0.4608446226791644
522,War,67179155,4654000,62525155,2019.csv,2019,0.06927744178979328,0.9307225582102068
523,Mulan,66800000,0,66800000,2020.csv,2020,0.0,1.0
524,A Violent Prosecutor,66736633,0,66736633,2015.csv,2015,0.0,1.0
525,Victoria & Abdul,66558465,22245070,44313395,2017.csv,2017,0.33421849497280326,0.6657815050271968
526,Love Simon,66316289,40826341,25489948,2018.csv,2018,0.615630663531248,0.38436933646875204
527,Mile 22,66308758,36108758,30200000,2018.csv,2018,0.5445548836851989,0.4554451163148011
528,One Piece Film: Gold,66207073,423593,65783480,2016.csv,2016,0.00639800221949096,0.9936019977805091
529,Life of the Party,65859911,53059911,12800000,2018.csv,2018,0.8056480823364611,0.1943519176635389
530,The Age of Adaline,65663276,42629776,23033500,2015.csv,2015,0.6492179281460158,0.35078207185398425
531,Eiga Doraemon: Nobita no getsumen tansaki,65406606,0,65406606,2019.csv,2019,0.0,1.0
532,Moonlight,65336603,27854932,37481671,2016.csv,2016,0.42632966394044086,0.5736703360595592
533,Stand by Me Doraemon 2,65066630,0,65066630,2020.csv,2020,0.0,1.0
534,Happy Death Day 2U,64600152,28148130,36452022,2019.csv,2019,0.43572854131984085,0.5642714586801592
535,L Storm,64517456,0,64517456,2018.csv,2018,0.0,1.0
536,Monster Trucks,64493915,33370166,31123749,2016.csv,2016,0.5174157282900255,0.4825842717099745
537,Monk Comes Down the Mountain,64455686,0,64455686,2015.csv,2015,0.0,1.0
538,Capernaum,64417003,1661096,62755907,2018.csv,2018,0.025786607923997954,0.974213392076002
539,Fences,64414761,57682904,6731857,2016.csv,2016,0.8954920130806664,0.10450798691933359
540,Zhongkui: Snow Girl and the Dark Crystal,64325947,165428,64160519,2015.csv,2015,0.002571714956641058,0.9974282850433589
541,Isle of Dogs,64241499,32015231,32226268,2018.csv,2018,0.49835747139088393,0.5016425286091161
542,Suck Me Shakespeer 3,64236772,0,64236772,2017.csv,2017,0.0,1.0
543,The Danish Girl,64191523,11114018,53077505,2015.csv,2015,0.1731384064528271,0.8268615935471729
544,The Boy,64188367,35819556,28368811,2015.csv,2015,0.5580381255064488,0.4419618744935511
545,Hail Caesar!,63647656,30498085,33149571,2016.csv,2016,0.4791705919225054,0.5208294080774947
546,The Rescue,63426575,18797,63407778,2020.csv,2020,0.0002963584270473378,0.9997036415729527
547,The Hundred Regiments Offensive,63230000,0,63230000,2015.csv,2015,0.0,1.0
548,Detective Conan: Crimson Love Letter,63144805,0,63144805,2017.csv,2017,0.0,1.0
549,The Longest Ride,62944815,37446117,25498698,2015.csv,2015,0.5949039170263667,0.4050960829736333
550,Unfriended,62882090,32482090,30400000,2015.csv,2015,0.5165555088897331,0.4834444911102668
551,The Mountain Between Us,62832209,30348555,32483654,2017.csv,2017,0.48300951825519933,0.5169904817448007
552,The Star,62812974,40852824,21960150,2017.csv,2017,0.65038830990553,0.34961169009446996
553,The Nice Guys,62788218,36261763,26526455,2016.csv,2016,0.5775249585837904,0.4224750414162097
554,How to Be a Latin Lover,62547032,32149404,30397628,2017.csv,2017,0.5140036700702281,0.4859963299297719
555,Andhadhun,62475342,1193046,61282296,2018.csv,2018,0.019096270013215774,0.9809037299867842
556,47 Meters Down,62187529,44307191,17880338,2017.csv,2017,0.7124771109654477,0.28752288903455225
557,Brooklyn,62076141,38322743,23753398,2015.csv,2015,0.6173506017392415,0.3826493982607585
558,"Dragon Ball Z: Resurrection ""F""",61768190,8008363,53759827,2015.csv,2015,0.1296518968744268,0.8703481031255732
559,White Snake,61631776,34730,61597046,2019.csv,2019,0.000563508018980339,0.9994364919810197
560,Everything Everything,61621140,34121140,27500000,2017.csv,2017,0.5537245821807256,0.4462754178192744
561,Woman in Gold,61619773,33307793,28311980,2015.csv,2015,0.540537418078447,0.459462581921553
562,Krampus,61548707,42725475,18823232,2015.csv,2015,0.694173396688902,0.305826603311098
563,Bombshell,61404394,31762808,29641586,2019.csv,2019,0.5172725587032094,0.48272744129679057
564,Ashfall,61354854,372562,60982292,2019.csv,2019,0.006072249801132279,0.9939277501988677
565,Doraemon: Great Adventure in the Antarctic Kachi Kochi,61153455,0,61153455,2017.csv,2017,0.0,1.0
566,Ma,61105672,45896028,15209644,2019.csv,2019,0.7510927627144007,0.24890723728559927
567,Snatched,60845711,45852178,14993533,2017.csv,2017,0.7535811028652455,0.24641889713475448
568,Love You Forever,60670799,0,60670799,2020.csv,2020,0.0,1.0
569,The Founding of an Army,60600361,0,60600361,2017.csv,2017,0.0,1.0
570,My Little Pony: The Movie,60330833,21885107,38445726,2017.csv,2017,0.3627516132588456,0.6372483867411544
571,The Perfect Guy,60273173,57027435,3245738,2015.csv,2015,0.9461495415215655,0.05385045847843451
572,My Best Summer,60011073,0,60011073,2019.csv,2019,0.0,1.0
573,Forever Young,59981902,149761,59832141,2015.csv,2015,0.0024967697756566637,0.9975032302243433
574,Adrift,59945012,31445012,28500000,2018.csv,2018,0.5245642790095696,0.47543572099043035
575,Miss Granny,59396311,234573,59161738,2015.csv,2015,0.003949285671967069,0.9960507143280329
576,Molly's Game,59284015,28780744,30503271,2017.csv,2017,0.48547224745152634,0.5145277525484736
577,The Devotion of Suspect X,59035664,686435,58349229,2017.csv,2017,0.011627463019641822,0.9883725369803582
578,The Gift,58978653,43787265,15191388,2015.csv,2015,0.742425653566554,0.257574346433446
579,Shock Wave,58815633,0,58815633,2017.csv,2017,0.0,1.0
580,Huo guo ying xiong,58106427,779818,57326609,2016.csv,2016,0.013420511985705126,0.9865794880142948
581,L.O.R.D: Legend of Ravaging Dynasties,58089494,350456,57739038,2016.csv,2016,0.0060330358532646195,0.9939669641467354
582,Nine Lives,57814445,19700032,38114413,2016.csv,2016,0.3407458464748732,0.6592541535251268
583,Goldbuster,57628292,186135,57442157,2017.csv,2017,0.0032299239408310073,0.996770076059169
584,Ready or Not,57615777,28714231,28901546,2019.csv,2019,0.4983744469852416,0.5016255530147584
585,Jade Dynasty,57149764,0,57149764,2019.csv,2019,0.0,1.0
586,The 15:17 to Paris,57076286,36276286,20800000,2018.csv,2018,0.6355754472181319,0.36442455278186814
587,All the Money in the World,56996304,25113707,31882597,2017.csv,2017,0.44061992160053043,0.5593800783994696
588,Zoolander 2,56722693,28848693,27874000,2016.csv,2016,0.5085917377018754,0.4914082622981247
589,You Are My Sunshine,56640000,0,56640000,2015.csv,2015,0.0,1.0
590,Das perfekte Geheimnis,56573047,0,56573047,2019.csv,2019,0.0,1.0
591,The Big Sick,56411585,42873127,13538458,2017.csv,2017,0.7600057151381228,0.2399942848618772
592,A or B,56239049,0,56239049,2018.csv,2018,0.0,1.0
593,The Big Shot,56040681,0,56040681,2019.csv,2019,0.0,1.0
594,Gongjo,55972241,475618,55496623,2017.csv,2017,0.008497390697649572,0.9915026093023505
595,All Eyez on Me,55668698,44922302,10746396,2017.csv,2017,0.806958014358446,0.1930419856415539
596,Hellboy,55064690,21903748,33160942,2019.csv,2019,0.39778209956325916,0.6022179004367408
597,Barbershop: The Next Cut,55030051,54030051,1000000,2016.csv,2016,0.9818281106081476,0.018171889391852464
598,Downsizing,55003890,24449754,30554136,2017.csv,2017,0.44450954287051336,0.5554904571294866
599,Go Brother!,54663060,0,54663060,2018.csv,2018,0.0,1.0
600,Early Man,54622814,8267544,46355270,2018.csv,2018,0.15135697695838227,0.8486430230416178
601,The Age of Shadows,54491162,541719,53949443,2016.csv,2016,0.009941410315309481,0.9900585896846905
602,No Escape,54418872,27288872,27130000,2015.csv,2015,0.5014597141962075,0.4985402858037925
603,I Tonya,53939297,30014539,23924758,2017.csv,2017,0.5564503185868366,0.4435496814131634
604,Peppermint,53918723,35418723,18500000,2018.csv,2018,0.6568909838610235,0.34310901613897643
605,Long Shot,53873809,30316271,23557538,2019.csv,2019,0.5627274470234692,0.4372725529765308
606,1987: When the Day Comes,53833618,0,53833618,2017.csv,2017,0.0,1.0
607,Sinister 2,53329150,27740955,25588195,2015.csv,2015,0.5201837081596088,0.4798162918403912
608,A Chinese Odyssey: Part Three,53306108,0,53306108,2016.csv,2016,0.0,1.0
609,The Outlaws,52946454,0,52946454,2017.csv,2017,0.0,1.0
610,Detective Conan: Sunflowers of Inferno,52920296,0,52920296,2015.csv,2015,0.0,1.0
611,Prem Ratan Dhan Payo,52715771,4364639,48351132,2015.csv,2015,0.08279569694617575,0.9172043030538243
612,Teo-neol,52444295,568876,51875419,2016.csv,2016,0.010847242774452398,0.9891527572255476
613,The Boy Next Door,52425855,35423380,17002475,2015.csv,2015,0.6756853083273511,0.3243146916726489
614,The Night Before,52395996,43047372,9348624,2015.csv,2015,0.8215775113808315,0.17842248861916854
615,Greenland,52300000,0,52300000,2020.csv,2020,0.0,1.0
616,Hollywood Adventures,52265070,0,52265070,2015.csv,2015,0.0,1.0
617,Tolo Tolo,52186426,0,52186426,2020.csv,2020,0.0,1.0
618,Patriots Day,52185751,31886361,20299390,2016.csv,2016,0.6110166163940038,0.3889833836059962
619,My Beloved Bodyguard,52165873,0,52165873,2016.csv,2016,0.0,1.0
620,The Finest Hours,52099090,27569558,24529532,2016.csv,2016,0.5291754232175648,0.47082457678243517
621,Teen Titans GO! To the Movies,52090236,29790236,22300000,2018.csv,2018,0.5718967370391641,0.4281032629608359
622,Yo-kai Watch Movie: It's the Secret of Birth Meow!,51838845,257343,51581502,2015.csv,2015,0.004964288845555876,0.9950357111544441
623,Slender Man,51738549,30569484,21169065,2018.csv,2018,0.5908454061979975,0.4091545938020025
624,Master,51636415,597251,51039164,2016.csv,2016,0.011566469128424194,0.9884335308715758
625,Breaking In,51411620,46840590,4571030,2018.csv,2018,0.9110895552406246,0.08891044475937541
626,Cry Me a Sad River,51400614,0,51400614,2018.csv,2018,0.0,1.0
627,Hot Pursuit,51380201,34580201,16800000,2015.csv,2015,0.6730258022929883,0.3269741977070117
628,Simmba,51329025,5102129,46226896,2018.csv,2018,0.09940046591572702,0.900599534084273
629,Once Upon a Deadpool 2018 Re-release,51247568,6100309,45147259,2018.csv,2018,0.11903606820912946,0.8809639317908705
630,Doraemon the Movie: Nobita and the Birth of Japan,50939840,0,50939840,2016.csv,2016,0.0,1.0
631,Vanguard,50814965,793525,50021440,2020.csv,2020,0.015615970610232635,0.9843840293897673
632,Kingdom,50574061,0,50574061,2019.csv,2019,0.0,1.0
633,The Himalayas,50544493,696717,49847776,2015.csv,2015,0.013784231647154914,0.9862157683528451
634,Breakthrough,50444358,40713082,9731276,2019.csv,2019,0.8070889117074302,0.1929110882925698
635,Just Mercy,50401502,36001502,14400000,2019.csv,2019,0.7142942287711981,0.28570577122880186
636,Uncut Gems,50023780,50023780,0,2019.csv,2019,1.0,0.0
637,Family is Family,49954866,0,49954866,2018.csv,2018,0.0,1.0
638,21 Bridges,49939757,28539757,21400000,2019.csv,2019,0.5714836978481894,0.42851630215181064
639,The Wailing,49851770,786633,49065137,2016.csv,2016,0.015779439727014708,0.9842205602729853
640,The Boy and the Beast,49714378,490643,49223735,2015.csv,2015,0.009869237426645467,0.9901307625733545
641,Demain tout commence,49619118,0,49619118,2016.csv,2016,0.0,1.0
642,Song of Youth,49615508,0,49615508,2019.csv,2019,0.0,1.0
643,Surprise,49567466,0,49567466,2015.csv,2015,0.0,1.0
644,Death Wish,49562710,34017028,15545682,2018.csv,2018,0.6863431801852643,0.3136568198147357
645,The Grudge,49511319,21221803,28289516,2019.csv,2019,0.4286252806151256,0.5713747193848744
646,Entourage,49263404,32363404,16900000,2015.csv,2015,0.6569461582476112,0.34305384175238884
647,Little,48987096,40860481,8126615,2019.csv,2019,0.8341070268790786,0.16589297312092147
648,Never Gone,48980792,96421,48884371,2016.csv,2016,0.0019685471806989156,0.9980314528193011
649,Luck-Key,48913975,466505,48447470,2016.csv,2016,0.00953725392385305,0.9904627460761469
650,Florence Foster Jenkins,48902953,27383770,21519183,2016.csv,2016,0.559961481262696,0.44003851873730404
651,The Woman in Black 2: Angel of Death,48854305,26501323,22352982,2015.csv,2015,0.5424562482262311,0.457543751773769
652,Bleeding Steel,48825526,0,48825526,2017.csv,2017,0.0,1.0
653,Fantasy Island,48811343,27309289,21502054,2020.csv,2020,0.5594865316449088,0.44051346835509114
654,Isn't It Romantic,48791187,48791187,0,2019.csv,2019,1.0,0.0
655,Mother's Day,48782670,32492859,16289811,2016.csv,2016,0.6660738126879894,0.33392618731201057
656,Concussion,48623572,34542474,14081098,2015.csv,2015,0.7104059323325732,0.28959406766742685
657,The Legend of Hei,48507082,0,48507082,2019.csv,2019,0.0,1.0
658,Logan Lucky,48453605,27780977,20672628,2017.csv,2017,0.5733521169374292,0.4266478830625709
659,Boo 2! A Madea Halloween,48333932,47319572,1014360,2017.csv,2017,0.979013501322425,0.020986498677575
660,Sky Hunter,48065601,0,48065601,2017.csv,2017,0.0,1.0
661,Countdown,48021766,25621766,22400000,2019.csv,2019,0.5335448513076341,0.4664551486923659
662,After We Collided,47990414,2386483,45603931,2020.csv,2020,0.04972832699463689,0.9502716730053631
663,From Today It's My Turn: The Movie,47866854,0,47866854,2020.csv,2020,0.0,1.0
664,Midsommar,47863365,27426361,20437004,2019.csv,2019,0.5730136399728686,0.4269863600271314
665,Queen & Slim,47856414,43808310,4048104,2019.csv,2019,0.9154114639680273,0.08458853603197264
666,Phantom Thread,47756590,21198205,26558385,2017.csv,2017,0.4438802058522185,0.5561197941477815
667,Yo-kai Watch Movie: It's the Secret of Birth Meow! 2016 Re-release,47642462,0,47642462,2016.csv,2016,0.0,1.0
668,Inside Men,47616503,0,47616503,2015.csv,2015,0.0,1.0
669,Lie ri zhuo xin,47600000,0,47600000,2015.csv,2015,0.0,1.0
670,47 Meters Down: Uncaged,47582563,22260900,25321663,2019.csv,2019,0.46783734621441053,0.5321626537855895
671,Boonie Bears Winter,47581416,0,47581416,2015.csv,2015,0.0,1.0
672,The Magic Tuche,47427990,0,47427990,2018.csv,2018,0.0,1.0
673,Rough Night,47347283,22105643,25241640,2017.csv,2017,0.466883031070653,0.533116968929347
674,A Monster Calls,47309313,3740823,43568490,2016.csv,2016,0.07907159843982516,0.9209284015601749
675,Golden Job,47287851,285795,47002056,2018.csv,2018,0.006043729921243407,0.9939562700787566
676,Mortdecai,47275695,7696134,39579561,2015.csv,2015,0.16279261468287246,0.8372073853171276
677,Son of Bigfoot,47046281,289308,46756973,2017.csv,2017,0.006149434000957483,0.9938505659990425
678,The New Mutants,46996076,23852659,23143417,2020.csv,2020,0.5075457576500643,0.4924542423499358
679,Trolls World Tour,46885895,0,46885895,2020.csv,2020,0.0,1.0
680,Mary Queen of Scots,46712809,16468499,30244310,2018.csv,2018,0.35254782044899075,0.6474521795510092
681,Uncle Drew,46664414,42469946,4194468,2018.csv,2018,0.9101142039413588,0.08988579605864118
682,Three Seconds,46596415,0,46596415,2017.csv,2017,0.0,1.0
683,Risen,46432579,36880033,9552546,2016.csv,2016,0.7942706133122608,0.20572938668773924
684,Acrimony,46403669,43549096,2854573,2018.csv,2018,0.9384838944523978,0.061516105547602284
685,The Thousand Faces of Dunjia,46263237,124187,46139050,2017.csv,2017,0.002684356047113608,0.9973156439528864
686,Asterix: The Secret of the Magic Potion,46221204,1271953,44949251,2018.csv,2018,0.027518820150163114,0.9724811798498368
687,The Battleship Island,46183383,1104957,45078426,2017.csv,2017,0.023925423566307388,0.9760745764336927
688,Hanson and the Beast,46154323,0,46154323,2017.csv,2017,0.0,1.0
689,Eddie the Eagle,46152800,15789389,30363411,2016.csv,2016,0.342111182853478,0.657888817146522
690,Let's Get Married,45972724,462918,45509806,2015.csv,2015,0.010069405502271303,0.9899305944977287
691,Gintama Live Action the Movie,45746967,0,45746967,2017.csv,2017,0.0,1.0
692,Somewhere Only We Know,45737711,482341,45255370,2015.csv,2015,0.010545805407708313,0.9894541945922917
693,Chasing the Dragon II: Wild Wild Bunch,45733356,196634,45536722,2019.csv,2019,0.004299575128490461,0.9957004248715096
694,McFarland USA,45710059,44482410,1227649,2015.csv,2015,0.9731426949153577,0.026857305084642312
695,Judy,45701880,24313888,21387992,2019.csv,2019,0.5320106743967644,0.4679893256032356
696,Guilty of Mind,45698503,0,45698503,2017.csv,2017,0.0,1.0
697,Bajrangi Bhaijaan 2018 Re-release,45579004,0,45579004,2018.csv,2018,0.0,1.0
698,Hero,45565534,88675,45476859,2015.csv,2015,0.0019460981188105905,0.9980539018811894
699,Tanhaji: The Unsung Warrior,45221814,0,45221814,2020.csv,2020,0.0,1.0
700,Blair Witch,45173154,20777061,24396093,2016.csv,2016,0.4599426686035693,0.5400573313964308
701,Flatliners,45158254,16883115,28275139,2017.csv,2017,0.3738655396198445,0.6261344603801555
702,Boonie Bears: The Big Top Secret,45150390,0,45150390,2016.csv,2016,0.0,1.0
703,Child's Play,44907074,29208403,15698671,2019.csv,2019,0.6504187513976083,0.3495812486023917
704,Still Alice,44779195,18754371,26024824,2015.csv,2015,0.41881885103115407,0.5811811489688459
705,Bad Genius,44560421,0,44560421,2017.csv,2017,0.0,1.0
706,Mother!,44516999,17800004,26716995,2017.csv,2017,0.3998473482006278,0.6001526517993722
707,Unhinged,44331465,20831465,23500000,2020.csv,2020,0.4699024722056896,0.5300975277943104
708,Winchester,44019588,25091816,18927772,2018.csv,2018,0.5700147852360635,0.4299852147639365
709,Wind River,43980821,33800859,10179962,2017.csv,2017,0.7685363354176585,0.23146366458234147
710,Max,43967255,42656255,1311000,2015.csv,2015,0.9701823550276223,0.029817644972377738
711,The End of Endless Love,43950000,0,43950000,2020.csv,2020,0.0,1.0
712,Battle of Memories,43892362,594552,43297810,2017.csv,2017,0.01354568250393998,0.98645431749606
713,Son of a Rich,43833888,0,43833888,2019.csv,2019,0.0,1.0
714,Café Society,43763247,11103205,32660042,2016.csv,2016,0.25371072215002693,0.746289277849973
715,Richard Jewell,43745542,22345542,21400000,2019.csv,2019,0.5108072955182497,0.4891927044817504
716,The DUFF,43709744,34030343,9679401,2015.csv,2015,0.7785527867653491,0.22144721323465083
717,League of Gods,43498766,181633,43317133,2016.csv,2016,0.004175589716728976,0.9958244102832711
718,Harriet,43347017,43082155,264862,2019.csv,2019,0.9938897294824232,0.006110270517576792
719,The Snowman,43155261,6700035,36455226,2017.csv,2017,0.1552541878961177,0.8447458121038823
720,A Shaun the Sheep Movie: Farmageddon,43100248,0,43100248,2019.csv,2019,0.0,1.0
721,Annihilation,43070915,32732301,10338614,2018.csv,2018,0.7599629819798349,0.2400370180201651
722,Gifted,43046590,24801212,18245378,2017.csv,2017,0.5761481223019059,0.42385187769809407
723,The Possession of Hannah Grace,43016528,14837422,28179106,2018.csv,2018,0.3449237465190124,0.6550762534809876
724,Legend,42972994,1872994,41100000,2015.csv,2015,0.04358537364187378,0.9564146263581262
725,The Gallows,42964410,22764410,20200000,2015.csv,2015,0.5298434215668271,0.47015657843317293
726,Train to Busan Presents: Peninsula,42698327,1231407,41466920,2020.csv,2020,0.02883970137752704,0.971160298622473
727,Almost Christmas,42580920,42158780,422140,2016.csv,2016,0.9900861700498721,0.009913829950127897
728,Love the Coopers,42426912,26302731,16124181,2015.csv,2015,0.6199539339558816,0.3800460660441184
729,Loving Vincent,42187665,6735118,35452547,2017.csv,2017,0.15964661708582353,0.8403533829141765
730,The Throne,42165755,0,42165755,2015.csv,2015,0.0,1.0
731,Long Day's Journey Into Night,42140994,521365,41619629,2018.csv,2018,0.01237191984602926,0.9876280801539707
732,Mary and the Witch's Flower,41978431,2418404,39560027,2017.csv,2017,0.05761063342267366,0.9423893665773263
733,Monster Hunter,41955901,15162470,26793431,2020.csv,2020,0.36139064204579946,0.6386093579542005
734,Call Me by Your Name,41887595,18095701,23791894,2017.csv,2017,0.4320062061333433,0.5679937938666567
735,T2 Trainspotting,41681746,2402004,39279742,2017.csv,2017,0.05762724047116452,0.9423727595288355
736,Overlord,41657844,21704844,19953000,2018.csv,2018,0.5210265802522089,0.47897341974779106
737,The Great Battle,41509280,472166,41037114,2018.csv,2018,0.0113749503725432,0.9886250496274568
738,The Lady in the Van,41387687,10021175,31366512,2015.csv,2015,0.24212938017048405,0.757870619829516
739,Ricki and the Flash,41325328,26822144,14503184,2015.csv,2015,0.6490485447568619,0.35095145524313803
740,The Darkest Minds,41142379,12695691,28446688,2018.csv,2018,0.30857940908084097,0.6914205909191591
741,Fist Fight,41087017,32187017,8900000,2017.csv,2017,0.7833865622320549,0.21661343776794503
742,Lost Found,41043552,0,41043552,2018.csv,2018,0.0,1.0
743,Underwater,40882928,17291078,23591850,2020.csv,2020,0.4229412824834855,0.5770587175165145
744,Fighting with My Family,40811919,22958886,17853033,2019.csv,2019,0.5625534540534592,0.43744654594654075
745,The War with Grandpa,40746845,21277892,19468953,2020.csv,2020,0.5221972891398095,0.47780271086019055
746,The Circle,40656399,20497844,20158555,2017.csv,2017,0.504172639588666,0.495827360411334
747,Ocho apellidos catalanes,40591862,0,40591862,2015.csv,2015,0.0,1.0
748,Holmes & Watson,40466970,30573626,9893344,2018.csv,2018,0.7555205146320567,0.24447948536794328
749,The Witch,40423945,25138705,15285240,2016.csv,2016,0.6218765882449128,0.37812341175508724
750,Masquerade Hotel,40396244,0,40396244,2019.csv,2019,0.0,1.0
751,Carol,40272135,12711491,27560644,2015.csv,2015,0.3156398586764769,0.6843601413235231
752,Diary of a Wimpy Kid: The Long Haul,40140972,20738724,19402248,2017.csv,2017,0.5166472799911273,0.48335272000887275
753,The Wild Life,40075446,8005586,32069860,2016.csv,2016,0.19976286726790266,0.8002371327320974
754,Northern Limit Line,40034677,337907,39696770,2015.csv,2015,0.008440357842777151,0.9915596421572228
755,Love O2O,39969537,0,39969537,2016.csv,2016,0.0,1.0
756,Brotherhood of Blades 2,39966092,14204,39951888,2017.csv,2017,0.0003554012736596813,0.9996445987263404
757,The Last Wish,39756292,0,39756292,2019.csv,2019,0.0,1.0
758,Midnight Runners,39730433,0,39730433,2017.csv,2017,0.0,1.0
759,The Forest,39712000,26594261,13117739,2016.csv,2016,0.6696782080983078,0.3303217919016922
760,Intimate Strangers,39576060,0,39576060,2018.csv,2018,0.0,1.0
761,Thugs of Hindostan,39570044,1449848,38120196,2018.csv,2018,0.0366400401273246,0.9633599598726754
762,Uri: The Surgical Strike,39346577,4186168,35160409,2019.csv,2019,0.10639217739322025,0.8936078226067797
763,Absolutely Fabulous: The Movie,39219109,4772155,34446954,2016.csv,2016,0.12167933238870877,0.8783206676112912
764,My Mom Is a Character 2,39195565,0,39195565,2016.csv,2016,0.0,1.0
765,Sink or Swim,39193850,0,39193850,2018.csv,2018,0.0,1.0
766,Show Dogs,39156854,17857020,21299834,2018.csv,2018,0.4560381689499366,0.5439618310500635
767,Masterpiece Mystery: Sherlock: The Abominable Bride,39139204,0,39139204,2016.csv,2016,0.0,1.0
768,Ex-Files 2: The Backup Strikes Back,39108291,0,39108291,2015.csv,2015,0.0,1.0
769,Believer,39047153,365639,38681514,2018.csv,2018,0.009364037372968011,0.990635962627032
770,The Spy Gone North,38844509,500803,38343706,2018.csv,2018,0.012892504317663018,0.987107495682337
771,Criminal,38803993,14708696,24095297,2015.csv,2015,0.3790510940459143,0.6209489059540857
772,On the Basis of Sex,38673750,24622687,14051063,2018.csv,2018,0.6366769966708685,0.36332300332913153
773,Crouching Tiger Hidden Dragon: Sword of Destiny,38659039,0,38659039,2016.csv,2016,0.0,1.0
774,Taxi 5,38598227,0,38598227,2018.csv,2018,0.0,1.0
775,Boruto: Naruto The Movie,38362448,919651,37442797,2015.csv,2015,0.023972688082887723,0.9760273119171122
776,The Lazarus Effect,38356892,25801570,12555322,2015.csv,2015,0.6726710287162996,0.3273289712837005
777,Overcomer,38026103,34746945,3279158,2019.csv,2019,0.9137656046426845,0.08623439535731547
778,Chek dou,37938005,0,37938005,2015.csv,2015,0.0,1.0
779,The King,37886707,0,37886707,2017.csv,2017,0.0,1.0
780,Hell or High Water,37879877,27007844,10872033,2016.csv,2016,0.7129865812394269,0.28701341876057307
781,Mission Milano,37749848,0,37749848,2016.csv,2016,0.0,1.0
782,The Handmaiden,37692886,2006788,35686098,2016.csv,2016,0.05324049742436809,0.9467595025756319
783,Pokémon the Movie: I Choose You!,37552144,2401722,35150422,2017.csv,2017,0.06395698738266449,0.9360430126173355
784,Fat Buddies,37496410,0,37496410,2018.csv,2018,0.0,1.0
785,A Walk in the Woods,37461274,29504281,7956993,2015.csv,2015,0.7875941699153104,0.21240583008468958
786,Sarileru Neekevvaru,37389889,821000,36568889,2020.csv,2020,0.021957807898279665,0.9780421921017204
787,Pain and Glory,37359689,4567338,32792351,2019.csv,2019,0.12225310547954508,0.877746894520455
788,Snowden,37357216,21587519,15769697,2016.csv,2016,0.5778674460109662,0.4221325539890339
789,Home Again,37270721,27020284,10250437,2017.csv,2017,0.7249734718037786,0.27502652819622136
790,A Witness Out of the Blue,37092694,0,37092694,2019.csv,2019,0.0,1.0
791,Till The End Of The World,37013733,118660,36895073,2018.csv,2018,0.003205837141582018,0.9967941628584179
792,2.0,36945969,4152000,32793969,2018.csv,2018,0.11238032490093845,0.8876196750990616
793,Ex Machina,36869414,25442958,11426456,2015.csv,2015,0.6900830590906598,0.3099169409093402
794,The Adventurers,36796816,216556,36580260,2017.csv,2017,0.0058851831093211975,0.9941148168906788
795,New Interpretation Records of the Three Kingdoms,36747486,0,36747486,2020.csv,2020,0.0,1.0
796,Burnt,36606743,13651946,22954797,2015.csv,2015,0.3729352813496683,0.6270647186503318
797,The Intruder,36599361,35419122,1180239,2019.csv,2019,0.9677524697767265,0.03224753022327357
798,The Priests,36577134,185093,36392041,2015.csv,2015,0.005060347265042691,0.9949396527349573
799,Nobunaga Concerto: The Movie,36187594,0,36187594,2016.csv,2016,0.0,1.0
800,The Confidence Man JP: Princess,36109913,0,36109913,2020.csv,2020,0.0,1.0
801,Nothing to Lose,36075317,1016188,35059129,2018.csv,2018,0.028168512005036575,0.9718314879949634
802,T-34,35950901,0,35950901,2018.csv,2018,0.0,1.0
803,The New Adventures of Aladdin,35771820,0,35771820,2015.csv,2015,0.0,1.0
804,Heidi,35755670,0,35755670,2015.csv,2015,0.0,1.0
805,Tad the Lost Explorer and the Secret of King Midas,35704046,5874,35698172,2017.csv,2017,0.00016451916962016014,0.9998354808303799
806,Hostiles,35669017,29819114,5849903,2017.csv,2017,0.835994835517895,0.164005164482105
807,The Queen's Corgi,35515687,0,35515687,2019.csv,2019,0.0,1.0
808,Mia and the White Lion,35487190,399471,35087719,2018.csv,2018,0.011256766173934877,0.9887432338260651
809,Room,35401758,14677654,20724104,2015.csv,2015,0.4146024047732319,0.5853975952267682
810,Namiya,35351623,70814,35280809,2017.csv,2017,0.0020031329254670996,0.997996867074533
811,Eye in the Sky,35259653,18704595,16555058,2016.csv,2016,0.5304815393390286,0.46951846066097136
812,Les Tuche 2: The American Dream,35210425,0,35210425,2016.csv,2016,0.0,1.0
813,Destiny: The Tale of Kamakura,35166640,0,35166640,2017.csv,2017,0.0,1.0
814,The Girl in the Spider's Web,35164920,14841338,20323582,2018.csv,2018,0.42204953118050603,0.577950468819494
815,The Liquidator,35046130,0,35046130,2017.csv,2017,0.0,1.0
816,The Hate U Give,34934009,29719483,5214526,2018.csv,2018,0.8507321046376326,0.14926789536236737
817,Lost and Love,34930177,188817,34741360,2015.csv,2015,0.005405555202311171,0.9945944447976889
818,Secret in Their Eyes,34854990,20180155,14674835,2015.csv,2015,0.578974631752871,0.42102536824712905
819,Dad Where Are We Going 2,34840000,0,34840000,2015.csv,2015,0.0,1.0
820,Kidnap,34814102,30971040,3843062,2017.csv,2017,0.8896119164584513,0.11038808354154876
821,Doraemon: Nobita and the Space Heroes,34811747,0,34811747,2015.csv,2015,0.0,1.0
822,The Man Standing Next,34664900,113527,34551373,2020.csv,2020,0.003274984205925879,0.9967250157940741
823,R.A.I.D. Special Unit,34598750,0,34598750,2017.csv,2017,0.0,1.0
824,Steve Jobs,34441873,17766658,16675215,2015.csv,2015,0.515844710303647,0.484155289696353
825,My Mom is a Character 3,34360029,0,34360029,2020.csv,2020,0.0,1.0
826,Warrior of the Hornor,34291831,0,34291831,2019.csv,2019,0.0,1.0
827,Victor Frankenstein,34227298,5775076,28452222,2015.csv,2015,0.16872719546836562,0.8312728045316343
828,The House,34184504,25584504,8600000,2017.csv,2017,0.748424022767743,0.25157597723225705
829,The Battle: Roar to Victory,34148707,0,34148707,2019.csv,2019,0.0,1.0
830,The Bad Guys: The Movie,34024386,166972,33857414,2019.csv,2019,0.004907421400638942,0.9950925785993611
831,The Witness,33963557,418063,33545494,2015.csv,2015,0.012309164202088727,0.9876908357979113
832,The Good Liar,33856058,17156058,16700000,2019.csv,2019,0.5067352495674482,0.49326475043255186
833,The Art of Racing in the Rain,33766787,26395642,7371145,2019.csv,2019,0.7817042823766442,0.21829571762335576
834,I Want to Eat Your Pancreas,33748006,277019,33470987,2017.csv,2017,0.008208455338072419,0.9917915446619275
835,Deliver Us from Evil,33718703,0,33718703,2020.csv,2020,0.0,1.0
836,Nobody's Fool,33705333,31713110,1992223,2018.csv,2018,0.9408929441521909,0.05910705584780901
837,Bloodshot,33542457,12561824,20980633,2020.csv,2020,0.37450518308781017,0.6254948169121898
838,Doraemon the Movie: Nobita's New Dinosaur,33479893,0,33479893,2020.csv,2020,0.0,1.0
839,Perfect Strangers,33262366,1014507,32247859,2017.csv,2017,0.03050014541960124,0.9694998545803988
840,Project Almanac,33213241,22348241,10865000,2015.csv,2015,0.6728714310054836,0.32712856899451637
841,Bharat,33185983,2971549,30214434,2019.csv,2019,0.08954229259986062,0.9104577074001394
842,Baaghi 2,33139063,1319579,31819484,2018.csv,2018,0.039819442088631175,0.9601805579113688
843,Sleepless,32917353,20783704,12133649,2017.csv,2017,0.6313905009312262,0.3686094990687738
844,Brightburn,32893421,17300439,15592982,2019.csv,2019,0.5259543846169117,0.4740456153830883
845,Hindi Medium,32841493,0,32841493,2017.csv,2017,0.0,1.0
846,Fly Me to the Saitama,32802347,0,32802347,2019.csv,2019,0.0,1.0
847,Steel Rain,32783733,0,32783733,2017.csv,2017,0.0,1.0
848,C'est la vie!,32764243,0,32764243,2017.csv,2017,0.0,1.0
849,The Hurricane Heist,32517248,6115825,26401423,2018.csv,2018,0.18807941557661953,0.8119205844233804
850,UglyDolls,32450241,20150241,12300000,2019.csv,2019,0.6209581309426947,0.3790418690573053
851,The House That Never Dies: Reawakening,32433588,0,32433588,2017.csv,2017,0.0,1.0
852,Stuber,32390945,22370452,10020493,2019.csv,2019,0.6906390659488323,0.3093609340511677
853,Hit Me Anyone One More Time!,32333512,0,32333512,2019.csv,2019,0.0,1.0
854,Somewhere Winter,32218990,0,32218990,2019.csv,2019,0.0,1.0
855,The Kid Who Would Be King,32140970,16790790,15350180,2019.csv,2019,0.5224108046521309,0.4775891953478691
856,Two Tigers,32001580,0,32001580,2019.csv,2019,0.0,1.0
857,Os Dez Mandamentos - O Filme,31998251,0,31998251,2016.csv,2016,0.0,1.0
858,Dilwale,31994323,4871263,27123060,2015.csv,2015,0.15225397955756087,0.8477460204424391
859,Suffragette,31972096,4702420,27269676,2015.csv,2015,0.1470788777814254,0.8529211222185746
860,All About Me,31920159,0,31920159,2018.csv,2018,0.0,1.0
861,Bounty Hunters,31918573,0,31918573,2016.csv,2016,0.0,1.0
862,Bad Times at the El Royale,31882724,17839115,14043609,2018.csv,2018,0.5595229253309724,0.44047707466902764
863,Self/less,31807156,12279691,19527465,2015.csv,2015,0.38606692783221486,0.6139330721677851
864,Hunter Killer,31672678,15767460,15905218,2018.csv,2018,0.49782528651350544,0.5021747134864946
865,Ae Dil Hai Mushkil,31668920,4264983,27403937,2016.csv,2016,0.1346740905594507,0.8653259094405493
866,Anna,31626978,7743794,23883184,2019.csv,2019,0.2448477372703772,0.7551522627296228
867,Super Troopers 2,31626386,30617396,1008990,2018.csv,2018,0.9680965760678442,0.03190342393215589
868,Harry Potter and the Sorcerer's Stone 2020 Re-release,31501815,0,31501815,2020.csv,2020,0.0,1.0
869,Assassination Classroom: The Graduation,31352921,0,31352921,2016.csv,2016,0.0,1.0
870,Perfect Strangers,31254929,0,31254929,2016.csv,2016,0.0,1.0
871,Saving Mr. Wu,31222161,92696,31129465,2015.csv,2015,0.0029689168536412326,0.9970310831463588
872,The Invisible Guest,31191910,0,31191910,2017.csv,2017,0.0,1.0
873,My Dear Liar,31177968,90545,31087423,2019.csv,2019,0.0029041340987969455,0.997095865901203
874,Honest Thief,31139004,14163574,16975430,2020.csv,2020,0.4548499367545603,0.5451500632454397
875,The Wild Goose Lake,31042413,12573,31029840,2019.csv,2019,0.00040502650357754084,0.9995949734964225
876,The Strangers: Prey at Night,31039126,24586708,6452418,2018.csv,2018,0.7921198554366512,0.20788014456334886
877,This Is Not What I Expected,30996615,337670,30658945,2017.csv,2017,0.010893770174581966,0.9891062298254181
878,Billy Lynn's Long Halftime Walk,30930984,1738477,29192507,2016.csv,2016,0.05620503376161586,0.9437949662383841
879,Pandora,30896701,0,30896701,2016.csv,2016,0.0,1.0
880,Gintama 2: Rules are Made to be Broken,30896653,0,30896653,2018.csv,2018,0.0,1.0
881,Attack on Titan Part 1,30810658,449523,30361135,2015.csv,2015,0.014589853939503662,0.9854101460604964
882,Norm of the North,30734502,17062499,13672003,2016.csv,2016,0.5551578157993254,0.44484218420067456
883,A Man Called Ove,30692889,3479315,27213574,2015.csv,2015,0.11335899334858963,0.8866410066514103
884,When the Bough Breaks,30658387,29747603,910784,2016.csv,2016,0.9702925010373181,0.02970749896268189
885,The Last Warrior,30618274,0,30618274,2017.csv,2017,0.0,1.0
886,Like a Boss,30399490,22169514,8229976,2020.csv,2020,0.7292725634541896,0.2707274365458105
887,S Storm,30381402,0,30381402,2016.csv,2016,0.0,1.0
888,The Way of the Bug,30355804,0,30355804,2018.csv,2018,0.0,1.0
889,Nocturnal Animals,30311857,10663357,19648500,2016.csv,2016,0.3517883117487655,0.6482116882512345
890,Far from the Madding Crowd,30229977,12236500,17993477,2015.csv,2015,0.40478032781831097,0.595219672181689
891,A Silent Voice: The Movie,30156463,310407,29846056,2016.csv,2016,0.010293216415996797,0.9897067835840032
892,Clergy,30114115,0,30114115,2018.csv,2018,0.0,1.0
893,My Hero Academia: Heroes Rising,29982484,13304000,16678484,2019.csv,2019,0.4437257433373432,0.5562742566626567
894,Reset 2017 Re-release,29949252,108970,29840282,2017.csv,2017,0.0036384881999724067,0.9963615118000276
895,Keeping Up with the Joneses,29918745,14904426,15014319,2016.csv,2016,0.4981634757741342,0.5018365242258658
896,The Bye Bye Man,29874280,22395806,7478474,2017.csv,2017,0.7496684773658143,0.2503315226341857
897,The Disaster Artist,29820616,21120616,8700000,2017.csv,2017,0.7082555236283516,0.2917444763716484
898,Ice,29806210,0,29806210,2018.csv,2018,0.0,1.0
899,Jackie,29777777,13960394,15817383,2016.csv,2016,0.46881921373781527,0.5311807862621847
900,The Swindlers,29721916,241916,29480000,2017.csv,2017,0.008139313764294335,0.9918606862357057
901,Masterminds,29674699,17368022,12306677,2016.csv,2016,0.5852804774868988,0.4147195225131011
902,Alibi.com,29370592,0,29370592,2017.csv,2017,0.0,1.0
903,Mr. Holmes,29355203,17737646,11617557,2015.csv,2015,0.6042419805443008,0.3957580194556992
904,Sword Art Online the Movie: Ordinal Scale,29322339,1522976,27799363,2017.csv,2017,0.05193910349375607,0.9480608965062439
905,Free Solo,29318861,17541090,11777771,2018.csv,2018,0.5982868843370143,0.4017131156629857
906,Fall In Love At First Kiss,29206238,0,29206238,2019.csv,2019,0.0,1.0
907,Dark Figure of Crime,29176133,0,29176133,2018.csv,2018,0.0,1.0
908,Flight Crew,29171110,0,29171110,2016.csv,2016,0.0,1.0
909,Viking,29161298,0,29161298,2016.csv,2016,0.0,1.0
910,Pad Man,29045020,1670192,27374828,2018.csv,2018,0.057503558269197265,0.9424964417308027
911,Recep Ivedik 5,28952258,0,28952258,2017.csv,2017,0.0,1.0
912,M.S. Dhoni: The Untold Story,28903047,1801550,27101497,2016.csv,2016,0.06233079854867897,0.937669201451321
913,Mirai,28756961,812794,27944167,2018.csv,2018,0.028264252262260953,0.9717357477377391
914,Judwaa 2,28733523,1431255,27302268,2017.csv,2017,0.04981133013170713,0.9501886698682929
915,Bath Buddy,28700000,0,28700000,2020.csv,2020,0.0,1.0
916,The Fortress,28645448,252895,28392553,2017.csv,2017,0.008828453302598025,0.9911715466974019
917,Love & Mercy,28641776,12551031,16090745,2015.csv,2015,0.43820714888629814,0.5617928511137019
918,Flying Colors,28525563,0,28525563,2015.csv,2015,0.0,1.0
919,Fan,28240000,2300000,25940000,2016.csv,2016,0.08144475920679886,0.9185552407932012
920,Gully Boy,28141995,5566534,22575461,2019.csv,2019,0.19780168392468267,0.8021983160753173
921,Yôkai Watch: the Movie: The Flying Whale and the Grand Adventure of the Double Worlds Meow!,28110245,0,28110245,2016.csv,2016,0.0,1.0
922,Triumph in the Skies,28085162,0,28085162,2015.csv,2015,0.0,1.0
923,Welcome to Germany,28036021,0,28036021,2016.csv,2016,0.0,1.0
924,The Brothers Grimsby,27979040,6874837,21104203,2016.csv,2016,0.24571382720779555,0.7542861727922044
925,What Happened to Monday,27975429,0,27975429,2017.csv,2017,0.0,1.0
926,The 33,27972023,12227722,15744301,2015.csv,2015,0.4371411392018375,0.5628588607981625
927,Monster Family,27890108,127259,27762849,2017.csv,2017,0.004562872255639885,0.9954371277443601
928,The Beguiled,27869129,10709995,17159134,2017.csv,2017,0.3842960072415611,0.6157039927584389
929,When Larry Meets Mary,27863090,0,27863090,2016.csv,2016,0.0,1.0
930,Kim Ji-young: Born 1982,27696393,0,27696393,2019.csv,2019,0.0,1.0
931,Default,27694043,203775,27490268,2018.csv,2018,0.007358080580722721,0.9926419194192773
932,Bride Wars,27670000,0,27670000,2015.csv,2015,0.0,1.0
933,One Cut of the Dead,27590180,52406,27537774,2018.csv,2018,0.0018994439325876091,0.9981005560674124
934,The Happytime Murders,27506452,20706452,6800000,2018.csv,2018,0.7527852737968532,0.2472147262031468
935,Yesterday Once More,27411872,0,27411872,2016.csv,2016,0.0,1.0
936,Irrational Man,27391084,4030360,23360724,2015.csv,2015,0.14714131065422603,0.852858689345774
937,Detective K: Secret of the Lost Island,27387870,185367,27202503,2015.csv,2015,0.006768215271943382,0.9932317847280566
938,Midnight Sun,27365467,9561064,17804403,2018.csv,2018,0.34938428056060583,0.6506157194393942
939,Pokémon: Mewtwo Strikes Back - Evolution,27347118,0,27347118,2019.csv,2019,0.0,1.0
940,To the Fore,27267799,0,27267799,2015.csv,2015,0.0,1.0
941,American Ultra,27262374,14440985,12821389,2015.csv,2015,0.5297038695162791,0.4702961304837209
942,VIP Policeman,27222681,0,27222681,2018.csv,2018,0.0,1.0
943,My Neighbor Totoro 2018 Re-release,27083857,1144649,25939208,2018.csv,2018,0.042263145902741994,0.9577368540972581
944,Almost a Comedy,26990962,0,26990962,2019.csv,2019,0.0,1.0
945,The Witches,26958129,0,26958129,2020.csv,2020,0.0,1.0
946,Total Dhamaal,26911995,2167632,24744363,2019.csv,2019,0.08054519926895051,0.9194548007310495
947,CHIPS,26800152,18600152,8200000,2017.csv,2017,0.6940315860895118,0.3059684139104883
948,The Faces of My Gene,26796279,0,26796279,2018.csv,2018,0.0,1.0
949,A Cure for Wellness,26620002,8106986,18513016,2017.csv,2017,0.3045449057441844,0.6954550942558156
950,Missing Link,26565710,16649539,9916171,2019.csv,2019,0.626730435587831,0.3732695644121689
951,No Manches Frida 2,26493648,9270920,17222728,2019.csv,2019,0.3499299152762957,0.6500700847237043
952,Emma.,26405753,10055355,16350398,2020.csv,2020,0.3808016760590012,0.6191983239409987
953,Only the Brave,26351322,18343983,8007339,2017.csv,2017,0.6961314123063731,0.3038685876936269
954,Twenty Two,26289378,46796,26242582,2017.csv,2017,0.0017800345067121785,0.9982199654932878
955,Orange,26261536,0,26261536,2015.csv,2015,0.0,1.0
956,Aloha,26250020,21067116,5182904,2015.csv,2015,0.8025561885286182,0.19744381147138174
957,The Confidence Man JP,26228317,0,26228317,2019.csv,2019,0.0,1.0
958,The Zookeeper's Wife,26152835,17571660,8581175,2017.csv,2017,0.6718835644395722,0.32811643556042774
959,Badrinath Ki Dulhania,26134309,1993259,24141050,2017.csv,2017,0.0762698183449197,0.9237301816550803
960,Badhaai Ho,26125610,0,26125610,2018.csv,2018,0.0,1.0
961,Hichki,26055222,330279,25724943,2018.csv,2018,0.012676115367583512,0.9873238846324165
962,The Light Between Oceans,25975621,12545979,13429642,2016.csv,2016,0.48299053177592943,0.5170094682240706
963,A Chinese Odyssey: Part 2 - Cinderella 2017 Re-release,25960664,0,25960664,2017.csv,2017,0.0,1.0
964,Love Off the Cuff,25959989,0,25959989,2017.csv,2017,0.0,1.0
965,The Confidence Man JP: The Movie,25958189,0,25958189,2019.csv,2019,0.0,1.0
966,White Boy Rick,25957482,24011188,1946294,2018.csv,2018,0.925019922964793,0.07498007703520704
967,Paul Apostle of Christ,25915966,17560475,8355491,2018.csv,2018,0.6775929170458087,0.32240708295419124
968,Huevos: Little Rooster's Egg-cellent Adventure,25892561,9080818,16811743,2015.csv,2015,0.3507114649647827,0.6492885350352172
969,Dügün Dernek 2: Sünnet,25836668,0,25836668,2015.csv,2015,0.0,1.0
970,Leap,25818882,83074,25735808,2020.csv,2020,0.00321756767004861,0.9967824323299513
971,The Gangster the Cop the Devil,25775371,216494,25558877,2019.csv,2019,0.008399258346271718,0.9916007416537282
972,A Beautiful Planet,25730120,15650615,10079505,2016.csv,2016,0.6082604744944835,0.3917395255055165
973,Champions,25690816,0,25690816,2018.csv,2018,0.0,1.0
974,Fireworks,25672406,525280,25147126,2017.csv,2017,0.020460879280266915,0.979539120719733
975,Father Figures,25601244,17501244,8100000,2017.csv,2017,0.6836091246191005,0.31639087538089944
976,Mr. Donkey,25537759,356255,25181504,2016.csv,2016,0.013950127730471574,0.9860498722695284
977,Look Who's Back,25513752,0,25513752,2015.csv,2015,0.0,1.0
978,Money,25403753,0,25403753,2017.csv,2017,0.0,1.0
979,Keys To The Heart,25375866,75134,25300732,2018.csv,2018,0.0029608447648643795,0.9970391552351356
980,Serial Teachers 2,25364150,0,25364150,2015.csv,2015,0.0,1.0
981,Bodies at Rest,25293853,0,25293853,2019.csv,2019,0.0,1.0
982,Born in China,25081168,13873211,11207957,2016.csv,2016,0.5531325734112542,0.4468674265887458
983,Race,25070261,19206207,5864054,2016.csv,2016,0.7660952153629353,0.2339047846370646
984,Call of Heroes,25040561,0,25040561,2016.csv,2016,0.0,1.0
985,Free State of Jones,25035950,20810036,4225914,2016.csv,2016,0.8312061655339622,0.16879383446603785
986,Whiskey Tango Foxtrot,24972139,23083334,1888805,2016.csv,2016,0.924363507667485,0.07563649233251504
987,Booksmart,24959607,22680962,2278645,2019.csv,2019,0.9087066955821861,0.09129330441781396
988,Scoob!,24900000,0,24900000,2020.csv,2020,0.0,1.0
989,Wild City,24817852,34866,24782986,2015.csv,2015,0.0014048758127818636,0.9985951241872182
990,Super 30,24701637,2269878,22431759,2019.csv,2019,0.09189180457959123,0.9081081954204088
991,Soulmate,24684439,0,24684439,2016.csv,2016,0.0,1.0
992,The Death of Stalin,24646055,8047856,16598199,2017.csv,2017,0.32653728963925466,0.6734627103607453
993,The Snow Queen 3: Fire and Ice,24644317,0,24644317,2016.csv,2016,0.0,1.0
994,God's Not Dead 2,24487848,20774575,3713273,2016.csv,2016,0.8483626245964937,0.15163737540350627
995,The 8-Year Engagement,24425963,0,24425963,2017.csv,2017,0.0,1.0
996,Stan & Ollie,24420923,5470235,18950688,2018.csv,2018,0.22399788083357866,0.7760021191664214
997,Skyfire,24375211,1105,24374106,2019.csv,2019,4.533294091279866e-05,0.9999546670590872
998,The Witch: Part 1 - The Subversion,24340302,0,24340302,2018.csv,2018,0.0,1.0
999,The Accidental Detective 2: In Action,24243825,179045,24064780,2018.csv,2018,0.0073851795250955655,0.9926148204749045
1000,Camping 3,24224579,0,24224579,2016.csv,2016,0.0,1.0
1001,Jolly LLB 2,24214186,1654254,22559932,2017.csv,2017,0.06831755566757437,0.9316824443324256
1002,The Founder,24121245,12786053,11335192,2016.csv,2016,0.5300743390318369,0.46992566096816313
1003,Start-Up,24106579,0,24106579,2019.csv,2019,0.0,1.0
1004,Bad Santa 2,24079268,17782178,6297090,2016.csv,2016,0.7384849904905747,0.2615150095094253
1005,I Can Speak,24024444,63239,23961205,2017.csv,2017,0.0026322773588433514,0.9973677226411567
1006,Killing for the Prosecution,23929620,0,23929620,2018.csv,2018,0.0,1.0
1007,Pinocchio,23883934,1831718,22052216,2019.csv,2019,0.07669247453120578,0.9233075254687942
1008,Spirits' Homecoming,23857217,125616,23731601,2016.csv,2016,0.0052653249538703525,0.9947346750461297
1009,Silence,23834809,7100177,16734632,2016.csv,2016,0.2978910802264033,0.7021089197735967
1010,Interstellar 2020 Re-release,23771122,0,23771122,2020.csv,2020,0.0,1.0
1011,The Peanut Butter Falcon,23743627,20457151,3286476,2019.csv,2019,0.8615849212927746,0.1384150787072253
1012,Pokémon the Movie: The Power of Us,23740788,789170,22951618,2018.csv,2018,0.0332411038757433,0.9667588961242567
1013,Nous finirons ensemble,23613535,0,23613535,2019.csv,2019,0.0,1.0
1014,Kevin Hart: What Now?,23591043,23591043,0,2016.csv,2016,1.0,0.0
1015,No manches Frida,23540937,11528613,12012324,2016.csv,2016,0.48972617360133114,0.5102738263986688
1016,Wish Upon,23468586,14301505,9167081,2017.csv,2017,0.6093892917110558,0.39061070828894423
1017,Ossan's Love: Love or Dead,23422744,0,23422744,2019.csv,2019,0.0,1.0
1018,Only Cloud Knows,23410836,0,23410836,2019.csv,2019,0.0,1.0
1019,Detroit,23355100,16790139,6564961,2017.csv,2017,0.7189067484189748,0.2810932515810251
1020,Middle School: The Worst Years of My Life,23316139,20007149,3308990,2016.csv,2016,0.8580815631610362,0.14191843683896377
1021,Triple 9,23177948,12639297,10538651,2016.csv,2016,0.5453156163781194,0.4546843836218806
1022,Rock Dog,23157646,9420546,13737100,2016.csv,2016,0.40680067395451164,0.5931993260454884
1023,The Guernsey Literary and Potato Peel Pie Society,23148937,0,23148937,2018.csv,2018,0.0,1.0
1024,The Crimes That Bind,23144130,0,23144130,2018.csv,2018,0.0,1.0
1025,New Happy Dad and Son 3: Adventure in Russia,23130469,0,23130469,2018.csv,2018,0.0,1.0
1026,Dark Waters,23108017,11136084,11971933,2019.csv,2019,0.48191430705629135,0.5180856929437087
1027,The Farewell,23076657,17695781,5380876,2019.csv,2019,0.7668260181706562,0.23317398182934382
1028,The Choice,23064015,18730891,4333124,2016.csv,2016,0.8121262061267304,0.1878737938732697
1029,Padmaavat,22991060,11846060,11145000,2018.csv,2018,0.5152463609768319,0.48475363902316815
1030,Penny Pincher!,22955486,0,22955486,2016.csv,2016,0.0,1.0
1031,Won't You Be My Neighbor?,22844741,22835787,8954,2018.csv,2018,0.9996080498351897,0.0003919501648103605
1032,The Knight of Shadows: Between Yin and Yang,22774256,0,22774256,2019.csv,2019,0.0,1.0
1033,Extraordinary Mission,22757764,54174,22703590,2017.csv,2017,0.0023804623336457836,0.9976195376663543
1034,Black and Blue,22741061,22055313,685748,2019.csv,2019,0.9698453823240701,0.030154617675929897
1035,Europe Raiders,22435156,0,22435156,2018.csv,2018,0.0,1.0
1036,Late Night,22386555,15499454,6887101,2019.csv,2019,0.6923554785450463,0.30764452145495363
1037,Mojin: The Worm Valley,22381583,101516,22280067,2018.csv,2018,0.004535693476194244,0.9954643065238058
1038,The Glass Castle,22088533,17273059,4815474,2017.csv,2017,0.7819921313923383,0.21800786860766172
1039,Stree,22075730,0,22075730,2018.csv,2018,0.0,1.0
1040,Gretel & Hansel,22051055,15347654,6703401,2020.csv,2020,0.6960054292186927,0.3039945707813073
1041,A Rainy Day in New York,22002504,0,22002504,2019.csv,2019,0.0,1.0
1042,Leap! 2017 Re-release,21929861,21858070,71791,2017.csv,2017,0.9967263358395204,0.003273664160479631
1043,Poupelle of Chimney Town,21824592,0,21824592,2020.csv,2020,0.0,1.0
1044,Épouse-moi mon pote,21571464,0,21571464,2017.csv,2017,0.0,1.0
1045,Crazy Romance,21386368,0,21386368,2019.csv,2019,0.0,1.0
1046,Shaft,21360215,21360215,0,2019.csv,2019,1.0,0.0
1047,Unplanned,21349929,19005109,2344820,2019.csv,2019,0.8901720001036069,0.1098279998963931
1048,Hotel Mumbai,21314816,9651611,11663205,2019.csv,2019,0.4528123067072219,0.5471876932927782
1049,Integrity,21290004,0,21290004,2019.csv,2019,0.0,1.0
1050,Stigmatized Properties,21276720,0,21276720,2020.csv,2020,0.0,1.0
1051,The Prison,21205329,207481,20997848,2017.csv,2017,0.009784380143312088,0.9902156198566879
1052,The Secret Mission,21083522,0,21083522,2019.csv,2019,0.0,1.0
1053,The Photograph,20690779,20578185,112594,2020.csv,2020,0.9945582522533347,0.005441747746665314
1054,Yarn,20444185,0,20444185,2020.csv,2020,0.0,1.0
1055,Brahms: The Boy II,20311536,12611536,7700000,2020.csv,2020,0.6209050856616654,0.37909491433833464
1056,Violet Evergarden: The Movie,20263658,0,20263658,2020.csv,2020,0.0,1.0
1057,This Is Tomas,20084169,0,20084169,2019.csv,2019,0.0,1.0
1058,Ice 2,19788995,0,19788995,2020.csv,2020,0.0,1.0
1059,Soul Snatcher,19561221,0,19561221,2020.csv,2020,0.0,1.0
1060,The Turning,19429304,15472775,3956529,2020.csv,2020,0.7963628033201807,0.2036371966798193
1061,The Specials,19363826,0,19363826,2019.csv,2019,0.0,1.0
1062,Fate/Stay Night: Heaven's Feel - III. Spring Song,19252497,200000,19052497,2020.csv,2020,0.010388262883510644,0.9896117371164893
1063,Always Miss You,19015465,91884,18923581,2019.csv,2019,0.0048320669518205316,0.9951679330481795
1064,An Officer and a Spy,18878658,0,18878658,2019.csv,2019,0.0,1.0
1065,Crayon Shin-chan: Honeymoon Hurricane - The Lost Hiroshi,18738951,0,18738951,2019.csv,2019,0.0,1.0
1066,Greta,18653107,10532219,8120888,2019.csv,2019,0.56463617562479,0.43536382437521
1067,Peppa Celebrates Chinese New Year,18653040,131225,18521815,2019.csv,2019,0.0070350462980833155,0.9929649537019167
1068,Black Christmas,18529730,10429730,8100000,2019.csv,2019,0.5628646504833044,0.4371353495166956
1069,How the Grinch Stole Christmas 2020 Re-release,18455781,420180,18035601,2020.csv,2020,0.022766850126797668,0.9772331498732023
1070,The Father,18395424,2122771,16272653,2020.csv,2020,0.11539668778496218,0.8846033122150379
1071,Takizawa Enbujo Zero,18091395,0,18091395,2020.csv,2020,0.0,1.0
1072,The Promised Neverland,17698106,0,17698106,2020.csv,2020,0.0,1.0
1073,Kaiji: Final Game,17645779,0,17645779,2020.csv,2020,0.0,1.0
1074,Hitman: Agent Jun,17601351,0,17601351,2020.csv,2020,0.0,1.0
1075,Digimon Adventure: Last Evolution Kizuna,17068434,0,17068434,2020.csv,2020,0.0,1.0
1076,Baaghi 3,16726510,721439,16005071,2020.csv,2020,0.043131472136147944,0.956868527863852
1077,Promising Young Woman,16322965,6460965,9862000,2020.csv,2020,0.39582055098445657,0.6041794490155434
1078,Pokémon the Movie: Secrets of the Jungle,16052056,0,16052056,2020.csv,2020,0.0,1.0
1079,I Still Believe,16021491,9868521,6152970,2020.csv,2020,0.6159552191490792,0.3840447808509208
1080,Freaky,15920855,9030855,6890000,2020.csv,2020,0.5672342974042537,0.43276570259574626
1081,Bye Bye Morons,15452122,0,15452122,2020.csv,2020,0.0,1.0
1082,The Way Back,14690514,13590514,1100000,2020.csv,2020,0.9251217486331655,0.0748782513668344
1083,The Personal History of David Copperfield,14323355,1876298,12447057,2020.csv,2020,0.1309957059641404,0.8690042940358597
1084,Nightlife,14292148,0,14292148,2020.csv,2020,0.0,1.0
1085,Pawn,14191042,0,14191042,2020.csv,2020,0.0,1.0
1086,The Lion King 2020 Re-release,13784186,0,13784186,2020.csv,2020,0.0,1.0
1087,#Alive,13432212,0,13432212,2020.csv,2020,0.0,1.0
1088,Howling Village,13394556,0,13394556,2020.csv,2020,0.0,1.0
1089,Come Play,13175457,10475990,2699467,2020.csv,2020,0.7951139759326754,0.20488602406732456
1090,Samjin Company English Class,12761386,0,12761386,2020.csv,2020,0.0,1.0
1091,News of the World,12668325,12668325,0,2020.csv,2020,1.0,0.0
1092,Collectors,12640113,0,12640113,2020.csv,2020,0.0,1.0
1093,No Escapes,12583300,0,12583300,2020.csv,2020,0.0,1.0
1094,Ducobu 3,12157793,0,12157793,2020.csv,2020,0.0,1.0
1095,Legend No. 17,11811335,0,11811335,2020.csv,2020,0.0,1.0
1096,Wotakoi: Love Is Hard for Otaku,11702371,0,11702371,2020.csv,2020,0.0,1.0
1097,Padre no hay más que uno 2: La llegada de la suegra,11700000,0,11700000,2020.csv,2020,0.0,1.0
1098,Let Him Go,11630934,9358025,2272909,2020.csv,2020,0.8045806983342868,0.19541930166571317
1099,The Hunt,11473631,5812500,5661131,2020.csv,2020,0.5065963860960842,0.49340361390391585
1100,The Voice of Sin,10983063,0,10983063,2020.csv,2020,0.0,1.0
1101,Me contro Te - Il film: La vendetta del Signor S,10779891,0,10779891,2020.csv,2020,0.0,1.0
1102,Impractical Jokers: The Movie,10691091,10691091,0,2020.csv,2020,1.0,0.0
1103,Shinchan: Crash! Scribble Kingdom and Almost Four Heroes,10628463,0,10628463,2020.csv,2020,0.0,1.0
1104,One Second,10600000,0,10600000,2020.csv,2020,0.0,1.0
1105,Honest Candidate,10597464,0,10597464,2020.csv,2020,0.0,1.0
1106,Street Dancer 3D,10339127,0,10339127,2020.csv,2020,0.0,1.0
1107,My Spy,10200000,0,10200000,2020.csv,2020,0.0,1.0
1108,The Asadas,10066797,0,10066797,2020.csv,2020,0.0,1.0
1109,Stolen Identity 2,9687188,0,9687188,2020.csv,2020,0.0,1.0
1110,10 Days with Dad,9472077,2359,9469718,2020.csv,2020,0.000249047806515931,0.9997509521934841
1111,365 Days,9458590,0,9458590,2020.csv,2020,0.0,1.0
1112,Secret Zoo,9457317,0,9457317,2020.csv,2020,0.0,1.0
1113,Okay Madam,9433525,0,9433525,2020.csv,2020,0.0,1.0
1114,A Quiet Place 2020 Re-release,9381052,0,9381052,2020.csv,2020,0.0,1.0
1115,Bohemian Rhapsody 2020 Re-release,9360701,240000,9120701,2020.csv,2020,0.02563910544733776,0.9743608945526623
1116,Bigfoot Family,9353378,0,9353378,2020.csv,2020,0.0,1.0
1117,L'appel de la forêt,9317347,0,9317347,2020.csv,2020,0.0,1.0
1118,Inception 10th Anniversary re-release,9100000,0,9100000,2020.csv,2020,0.0,1.0
1119,Break the Silence: The Movie,8954345,0,8954345,2020.csv,2020,0.0,1.0
1120,The Closet,8948595,0,8948595,2020.csv,2020,0.0,1.0
1121,I Hate Summer,8926364,0,8926364,2020.csv,2020,0.0,1.0
1122,30 jours max,8916866,0,8916866,2020.csv,2020,0.0,1.0
1123,Downhill,8899195,8287061,612134,2020.csv,2020,0.9312146772826081,0.06878532271739185
1124,Les blagues de Toto,8859185,0,8859185,2020.csv,2020,0.0,1.0
1125,The Secret Garden,8842172,0,8842172,2020.csv,2020,0.0,1.0
1126,Malasaña 32,8683909,0,8683909,2020.csv,2020,0.0,1.0
1127,Another Round,8643452,0,8643452,2020.csv,2020,0.0,1.0
1128,Eltilerin Savasi,8613864,0,8613864,2020.csv,2020,0.0,1.0
1129,Malang,8399765,0,8399765,2020.csv,2020,0.0,1.0
1130,100% Wolf,8169164,658764,7510400,2020.csv,2020,0.08064032011109093,0.9193596798889091
1131,Your Eyes Tell,8020474,0,8020474,2020.csv,2020,0.0,1.0
1132,AI Amok,7932191,0,7932191,2020.csv,2020,0.0,1.0
1133,The Lost Prince,7837980,0,7837980,2020.csv,2020,0.0,1.0
1134,The Marriage Escape,7760946,0,7760946,2020.csv,2020,0.0,1.0
1135,Spirited Away Studio Ghibli Fest 2020,7732435,0,7732435,2020.csv,2020,0.0,1.0
1136,Neposredstvenno Kakha,7692780,0,7692780,2020.csv,2020,0.0,1.0
1137,Princess Mononoke Studio Ghibli Fest 2020,7673207,0,7673207,2020.csv,2020,0.0,1.0
1138,The Heist of the Century,7558890,0,7558890,2020.csv,2020,0.0,1.0
1139,Fukushima 50,7494243,0,7494243,2020.csv,2020,0.0,1.0
1140,De Gaulle,7473247,0,7473247,2020.csv,2020,0.0,1.0
1141,Antoinette dans les Cévennes,7441698,0,7441698,2020.csv,2020,0.0,1.0
1142,The (UN)perfect Guy,7154649,0,7154649,2020.csv,2020,0.0,1.0
1143,Back to the Wharf,7090000,0,7090000,2020.csv,2020,0.0,1.0
1144,Adu,7085946,0,7085946,2020.csv,2020,0.0,1.0
1145,The Best Years,7035246,0,7035246,2020.csv,2020,0.0,1.0
1146,Fatale,6993043,6306897,686146,2020.csv,2020,0.9018816272115014,0.09811837278849851
1147,Spycies,6979672,0,6979672,2020.csv,2020,0.0,1.0
1148,Jim Button and the Wild 13,6880898,0,6880898,2020.csv,2020,0.0,1.0
1149,Antebellum,6852361,0,6852361,2020.csv,2020,0.0,1.0
1150,Psy 3: W imie zasad,6725146,0,6725146,2020.csv,2020,0.0,1.0
1151,Blood Moon Party,6709383,0,6709383,2020.csv,2020,0.0,1.0
1152,Innocence,6659968,0,6659968,2020.csv,2020,0.0,1.0
1153,Shubh Mangal Zyada Saavdhan,6574905,0,6574905,2020.csv,2020,0.0,1.0
1154,Silver Skates,6574310,0,6574310,2020.csv,2020,0.0,1.0
1155,Chhapaak,6532100,604334,5927766,2020.csv,2020,0.09251756709174691,0.907482432908253
1156,Love Me Love Me Not,6494241,0,6494241,2020.csv,2020,0.0,1.0
1157,Dragon Rider,6472379,0,6472379,2020.csv,2020,0.0,1.0
1158,Hammamet,6434874,0,6434874,2020.csv,2020,0.0,1.0
1159,Lindenberg! Mach dein Ding,6404964,0,6404964,2020.csv,2020,0.0,1.0
1160,Midnight Swan,6397065,0,6397065,2020.csv,2020,0.0,1.0
1161,Nausicaä of the Valley of the Wind 2020 Re-release,6395525,0,6395525,2020.csv,2020,0.0,1.0
1162,Simply Black,6323750,0,6323750,2020.csv,2020,0.0,1.0
1163,My Boyfriend's Meds,6292780,2971116,3321664,2020.csv,2020,0.47214680951820975,0.5278531904817902
1164,Bill & Ted Face the Music,6274027,3439660,2834367,2020.csv,2020,0.5482379977006793,0.4517620022993207
1165,Hotel Belgrade,6085659,0,6085659,2020.csv,2020,0.0,1.0
1166,The Legacy Of Dr. Death: Black File,6024046,0,6024046,2020.csv,2020,0.0,1.0
1167,The Rhythm Section,5989583,5437971,551612,2020.csv,2020,0.9079047740051353,0.09209522599486475
1168,Jak zostalem gangsterem. Historia prawdziwa,5975729,0,5975729,2020.csv,2020,0.0,1.0
1169,How to Be a Good Wife,5966014,0,5966014,2020.csv,2020,0.0,1.0
1170,Twiceborn,5880157,11527,5868630,2020.csv,2020,0.001960321807734045,0.9980396781922659
1171,The Royal Bride,5830719,0,5830719,2020.csv,2020,0.0,1.0
1172,Beasts Clawing at Straws,5796059,0,5796059,2020.csv,2020,0.0,1.0
1173,Last Letter,5663972,0,5663972,2020.csv,2020,0.0,1.0
1174,Yowamushi Pedal: The Movie 2020 Re-release,5624218,0,5624218,2020.csv,2020,0.0,1.0
1175,Klassikokkutulek 2: Pulmad ja matused,5543147,0,5543147,2020.csv,2020,0.0,1.0
1176,Hocus Pocus 2020 Re-release,5432992,4828000,604992,2020.csv,2020,0.8886447835741338,0.11135521642586627
1177,Two by Two: Overboard!,5360412,0,5360412,2020.csv,2020,0.0,1.0
1178,Divorce Club,5316313,0,5316313,2020.csv,2020,0.0,1.0
1179,Cindy La Regia,5222322,0,5222322,2020.csv,2020,0.0,1.0
1180,Mama Weed,5144345,0,5144345,2020.csv,2020,0.0,1.0
1181,Love Aaj Kal,5120794,0,5120794,2020.csv,2020,0.0,1.0
1182,Masked Ward,5106794,0,5106794,2020.csv,2020,0.0,1.0
1183,Ayyappanum Koshiyum,5088713,0,5088713,2020.csv,2020,0.0,1.0
1184,Baba Parasi,5084342,0,5084342,2020.csv,2020,0.0,1.0
1185,Die Känguru-Chroniken,5081127,0,5081127,2020.csv,2020,0.0,1.0
1186,The Real Exorcist,5035830,0,5035830,2020.csv,2020,0.0,1.0
1187,Mayday,5011408,0,5011408,2020.csv,2020,0.0,1.0
1188,Bheeshma,4997080,0,4997080,2020.csv,2020,0.0,1.0
1189,Made in Abyss: Dawn of the Deep Soul,4971635,0,4971635,2020.csv,2020,0.0,1.0
1190,Godai - The Wunderkind,4948225,0,4948225,2020.csv,2020,0.0,1.0
1191,Panga,4886124,582720,4303404,2020.csv,2020,0.11926017432222351,0.8807398256777765
1192,The Tales for Old and Young,4853143,0,4853143,2020.csv,2020,0.0,1.0
1193,Streltsov,4850073,0,4850073,2020.csv,2020,0.0,1.0
1194,The SpongeBob Movie: Sponge on the Run,4810790,4810790,0,2020.csv,2020,1.0,0.0
1195,The Vets,4788826,0,4788826,2020.csv,2020,0.0,1.0
1196,The Broken Hearts Gallery,4781389,4067442,713947,2020.csv,2020,0.8506820925885763,0.14931790741142376
1197,Gladiator 20th Anniversary,4780585,0,4780585,2020.csv,2020,0.0,1.0
1198,Intruder,4751103,0,4751103,2020.csv,2020,0.0,1.0
1199,Granny Nanny,4654655,432,4654223,2020.csv,2020,9.281031569471851e-05,0.9999071896843053
1200,Military Wives,4558564,0,4558564,2020.csv,2020,0.0,1.0
